date_administered,administering_provider_type,new_primary_series_doses,new_recipients,new_series_completed,new_booster_doses,new_booster_recipients,new_2nd_booster_recipients,new_bivalent_booster_doses,new_bivalent_booster_recipients,cumulative_primary_series_doses,cumulative_recipients,cumulative_series_completed,cumulative_booster_doses,cumulative_booster_recipients,cumulative_2nd_booster_recipients,cumulative_bivalent_booster_doses,cumulative_bivalent_booster_recipients,data_as_of,data_updated_at,data_loaded_at
2020/12/11,All Providers,0,0,0,0,0,0,0,0,0,0,0,0,0,0,0,0,11/01/2023 05:43:00 AM,11/01/2023 07:28:13 AM,11/01/2023 08:15:11 AM
2020/12/12,All Providers,1,1,0,0,0,0,0,0,1,1,0,0,0,0,0,0,11/01/2023 05:43:00 AM,11/01/2023 07:28:13 AM,11/01/2023 08:15:11 AM
2020/12/13,All Providers,0,0,0,0,0,0,0,0,1,1,0,0,0,0,0,0,11/01/2023 05:43:00 AM,11/01/2023 07:28:13 AM,11/01/2023 08:15:11 AM
2020/12/14,All Providers,1,1,0,0,0,0,0,0,2,2,0,0,0,0,0,0,11/01/2023 05:43:00 AM,11/01/2023 07:28:13 AM,11/01/2023 08:15:11 AM
2020/12/15,All Providers,13,13,0,0,0,0,0,0,15,15,0,0,0,0,0,0,11/01/2023 05:43:00 AM,11/01/2023 07:28:13 AM,11/01/2023 08:15:11 AM
2020/12/16,All Providers,229,229,0,0,0,0,0,0,244,244,0,0,0,0,0,0,11/01/2023 05:43:00 AM,11/01/2023 07:28:13 AM,11/01/2023 08:15:11 AM
2020/12/17,All Providers,417,417,0,0,0,0,0,0,661,661,0,0,0,0,0,0,11/01/2023 05:43:00 AM,11/01/2023 07:28:13 AM,11/01/2023 08:15:11 AM
2020/12/18,All Providers,942,942,1,0,0,0,0,0,1603,1603,1,0,0,0,0,0,11/01/2023 05:43:00 AM,11/01/2023 07:28:13 AM,11/01/2023 08:15:11 AM
2020/12/19,All Providers,650,650,0,0,0,0,0,0,2253,2253,1,0,0,0,0,0,11/01/2023 05:43:00 AM,11/01/2023 07:28:13 AM,11/01/2023 08:15:11 AM
2020/12/20,All Providers,499,499,2,0,0,0,0,0,2752,2752,3,0,0,0,0,0,11/01/2023 05:43:00 AM,11/01/2023 07:28:13 AM,11/01/2023 08:15:11 AM
2020/12/21,All Providers,1189,1189,1,0,0,0,0,0,3941,3941,4,0,0,0,0,0,11/01/2023 05:43:00 AM,11/01/2023 07:28:13 AM,11/01/2023 08:15:11 AM
2020/12/22,All Providers,1414,1414,1,0,0,0,0,0,5355,5355,5,0,0,0,0,0,11/01/2023 05:43:00 AM,11/01/2023 07:28:13 AM,11/01/2023 08:15:11 AM
2020/12/23,All Providers,1453,1453,7,0,0,0,0,0,6808,6808,12,0,0,0,0,0,11/01/2023 05:43:00 AM,11/01/2023 07:28:13 AM,11/01/2023 08:15:11 AM
2020/12/24,All Providers,877,877,1,0,0,0,0,0,7685,7685,13,0,0,0,0,0,11/01/2023 05:43:00 AM,11/01/2023 07:28:13 AM,11/01/2023 08:15:11 AM
2020/12/25,All Providers,47,47,0,0,0,0,0,0,7732,7732,13,0,0,0,0,0,11/01/2023 05:43:00 AM,11/01/2023 07:28:13 AM,11/01/2023 08:15:11 AM
2020/12/26,All Providers,274,274,0,0,0,0,0,0,8006,8006,13,0,0,0,0,0,11/01/2023 05:43:00 AM,11/01/2023 07:28:13 AM,11/01/2023 08:15:11 AM
2020/12/27,All Providers,294,294,1,0,0,0,0,0,8300,8300,14,0,0,0,0,0,11/01/2023 05:43:00 AM,11/01/2023 07:28:13 AM,11/01/2023 08:15:11 AM
2020/12/28,All Providers,1273,1273,6,0,0,0,0,0,9573,9573,20,0,0,0,0,0,11/01/2023 05:43:00 AM,11/01/2023 07:28:13 AM,11/01/2023 08:15:11 AM
2020/12/29,All Providers,1416,1416,3,0,0,0,0,0,10989,10989,23,0,0,0,0,0,11/01/2023 05:43:00 AM,11/01/2023 07:28:13 AM,11/01/2023 08:15:11 AM
2020/12/30,All Providers,1661,1661,5,0,0,0,0,0,12650,12650,28,0,0,0,0,0,11/01/2023 05:43:00 AM,11/01/2023 07:28:13 AM,11/01/2023 08:15:11 AM
2020/12/31,All Providers,1063,1063,0,0,0,0,0,0,13713,13713,28,0,0,0,0,0,11/01/2023 05:43:00 AM,11/01/2023 07:28:13 AM,11/01/2023 08:15:11 AM
2021/01/01,All Providers,97,97,2,0,0,0,0,0,13810,13810,30,0,0,0,0,0,11/01/2023 05:43:00 AM,11/01/2023 07:28:13 AM,11/01/2023 08:15:11 AM
2021/01/02,All Providers,383,383,2,0,0,0,0,0,14193,14193,32,0,0,0,0,0,11/01/2023 05:43:00 AM,11/01/2023 07:28:13 AM,11/01/2023 08:15:11 AM
2021/01/03,All Providers,315,315,0,0,0,0,0,0,14508,14508,32,0,0,0,0,0,11/01/2023 05:43:00 AM,11/01/2023 07:28:13 AM,11/01/2023 08:15:11 AM
2021/01/04,All Providers,1856,1835,23,0,0,0,0,0,16364,16343,55,0,0,0,0,0,11/01/2023 05:43:00 AM,11/01/2023 07:28:13 AM,11/01/2023 08:15:11 AM
2021/01/05,All Providers,2205,2150,56,0,0,0,0,0,18569,18493,111,0,0,0,0,0,11/01/2023 05:43:00 AM,11/01/2023 07:28:13 AM,11/01/2023 08:15:11 AM
2021/01/06,All Providers,1894,1614,281,0,0,0,0,0,20463,20107,392,0,0,0,0,0,11/01/2023 05:43:00 AM,11/01/2023 07:28:13 AM,11/01/2023 08:15:11 AM
2021/01/07,All Providers,2112,1613,502,0,0,0,0,0,22575,21720,894,0,0,0,0,0,11/01/2023 05:43:00 AM,11/01/2023 07:28:13 AM,11/01/2023 08:15:11 AM
2021/01/08,All Providers,2381,1479,904,0,0,0,0,0,24956,23199,1798,0,0,0,0,0,11/01/2023 05:43:00 AM,11/01/2023 07:28:13 AM,11/01/2023 08:15:11 AM
2021/01/09,All Providers,1432,899,536,0,0,0,0,0,26388,24098,2334,0,0,0,0,0,11/01/2023 05:43:00 AM,11/01/2023 07:28:13 AM,11/01/2023 08:15:11 AM
2021/01/10,All Providers,905,441,465,0,0,0,0,0,27293,24539,2799,0,0,0,0,0,11/01/2023 05:43:00 AM,11/01/2023 07:28:13 AM,11/01/2023 08:15:11 AM
2021/01/11,All Providers,2563,1440,1124,0,0,0,0,0,29856,25979,3923,0,0,0,0,0,11/01/2023 05:43:00 AM,11/01/2023 07:28:13 AM,11/01/2023 08:15:11 AM
2021/01/12,All Providers,3067,1867,1201,0,0,0,0,0,32923,27846,5124,0,0,0,0,0,11/01/2023 05:43:00 AM,11/01/2023 07:28:13 AM,11/01/2023 08:15:11 AM
2021/01/13,All Providers,2906,2016,890,0,0,0,0,0,35829,29862,6014,0,0,0,0,0,11/01/2023 05:43:00 AM,11/01/2023 07:28:13 AM,11/01/2023 08:15:11 AM
2021/01/14,All Providers,2537,1980,558,0,0,0,0,0,38366,31842,6572,0,0,0,0,0,11/01/2023 05:43:00 AM,11/01/2023 07:28:13 AM,11/01/2023 08:15:11 AM
2021/01/15,All Providers,2818,2414,409,0,0,0,0,0,41184,34256,6981,0,0,0,0,0,11/01/2023 05:43:00 AM,11/01/2023 07:28:13 AM,11/01/2023 08:15:11 AM
2021/01/16,All Providers,2270,2098,174,0,0,0,0,0,43454,36354,7155,0,0,0,0,0,11/01/2023 05:43:00 AM,11/01/2023 07:28:13 AM,11/01/2023 08:15:11 AM
2021/01/17,All Providers,1938,1625,313,0,0,0,0,0,45392,37979,7468,0,0,0,0,0,11/01/2023 05:43:00 AM,11/01/2023 07:28:13 AM,11/01/2023 08:15:11 AM
2021/01/18,All Providers,1392,1128,264,0,0,0,0,0,46784,39107,7732,0,0,0,0,0,11/01/2023 05:43:00 AM,11/01/2023 07:28:13 AM,11/01/2023 08:15:11 AM
2021/01/19,All Providers,2756,1842,915,0,0,0,0,0,49540,40949,8647,0,0,0,0,0,11/01/2023 05:43:00 AM,11/01/2023 07:28:13 AM,11/01/2023 08:15:11 AM
2021/01/20,All Providers,2939,2138,802,0,0,0,0,0,52479,43087,9449,0,0,0,0,0,11/01/2023 05:43:00 AM,11/01/2023 07:28:13 AM,11/01/2023 08:15:11 AM
2021/01/21,All Providers,3492,2606,888,0,0,0,0,0,55971,45693,10337,0,0,0,0,0,11/01/2023 05:43:00 AM,11/01/2023 07:28:13 AM,11/01/2023 08:15:11 AM
2021/01/22,All Providers,3393,2891,503,0,0,0,0,0,59364,48584,10840,0,0,0,0,0,11/01/2023 05:43:00 AM,11/01/2023 07:28:13 AM,11/01/2023 08:15:11 AM
2021/01/23,All Providers,3142,2744,400,0,0,0,0,0,62506,51328,11240,0,0,0,0,0,11/01/2023 05:43:00 AM,11/01/2023 07:28:13 AM,11/01/2023 08:15:11 AM
2021/01/24,All Providers,2435,2191,244,0,0,0,0,0,64941,53519,11484,0,0,0,0,0,11/01/2023 05:43:00 AM,11/01/2023 07:28:13 AM,11/01/2023 08:15:11 AM
2021/01/25,All Providers,4656,3066,1592,0,0,0,0,0,69597,56585,13076,0,0,0,0,0,11/01/2023 05:43:00 AM,11/01/2023 07:28:13 AM,11/01/2023 08:15:11 AM
2021/01/26,All Providers,4828,3164,1667,0,0,0,0,0,74425,59749,14743,0,0,0,0,0,11/01/2023 05:43:00 AM,11/01/2023 07:28:13 AM,11/01/2023 08:15:11 AM
2021/01/27,All Providers,4369,3038,1331,0,0,0,0,0,78794,62787,16074,0,0,0,0,0,11/01/2023 05:43:00 AM,11/01/2023 07:28:13 AM,11/01/2023 08:15:11 AM
2021/01/28,All Providers,3946,2711,1237,0,0,0,0,0,82740,65498,17311,0,0,0,0,0,11/01/2023 05:43:00 AM,11/01/2023 07:28:13 AM,11/01/2023 08:15:11 AM
2021/01/29,All Providers,4906,3593,1313,0,0,0,0,0,87646,69091,18624,0,0,0,0,0,11/01/2023 05:43:00 AM,11/01/2023 07:28:13 AM,11/01/2023 08:15:11 AM
2021/01/30,All Providers,3739,3269,472,0,0,0,0,0,91385,72360,19096,0,0,0,0,0,11/01/2023 05:43:00 AM,11/01/2023 07:28:13 AM,11/01/2023 08:15:11 AM
2021/01/31,All Providers,2336,2182,155,0,0,0,0,0,93721,74542,19251,0,0,0,0,0,11/01/2023 05:43:00 AM,11/01/2023 07:28:13 AM,11/01/2023 08:15:11 AM
2021/02/01,All Providers,4063,2960,1105,0,0,0,0,0,97784,77502,20356,0,0,0,0,0,11/01/2023 05:43:00 AM,11/01/2023 07:28:13 AM,11/01/2023 08:15:11 AM
2021/02/02,All Providers,4546,2982,1564,0,0,0,0,0,102330,80484,21920,0,0,0,0,0,11/01/2023 05:43:00 AM,11/01/2023 07:28:13 AM,11/01/2023 08:15:11 AM
2021/02/03,All Providers,5133,3815,1319,0,0,0,0,0,107463,84299,23239,0,0,0,0,0,11/01/2023 05:43:00 AM,11/01/2023 07:28:13 AM,11/01/2023 08:15:11 AM
2021/02/04,All Providers,5177,3946,1231,0,0,0,0,0,112640,88245,24470,0,0,0,0,0,11/01/2023 05:43:00 AM,11/01/2023 07:28:13 AM,11/01/2023 08:15:11 AM
2021/02/05,All Providers,6208,4815,1396,0,0,0,0,0,118848,93060,25866,0,0,0,0,0,11/01/2023 05:43:00 AM,11/01/2023 07:28:13 AM,11/01/2023 08:15:11 AM
2021/02/06,All Providers,5684,4835,851,0,0,0,0,0,124532,97895,26717,0,0,0,0,0,11/01/2023 05:43:00 AM,11/01/2023 07:28:13 AM,11/01/2023 08:15:11 AM
2021/02/07,All Providers,4496,3940,559,0,0,0,0,0,129028,101835,27276,0,0,0,0,0,11/01/2023 05:43:00 AM,11/01/2023 07:28:13 AM,11/01/2023 08:15:11 AM
2021/02/08,All Providers,7100,5814,1290,0,0,0,0,0,136128,107649,28566,0,0,0,0,0,11/01/2023 05:43:00 AM,11/01/2023 07:28:13 AM,11/01/2023 08:15:11 AM
2021/02/09,All Providers,6274,4649,1627,0,0,0,0,0,142402,112298,30193,0,0,0,0,0,11/01/2023 05:43:00 AM,11/01/2023 07:28:13 AM,11/01/2023 08:15:11 AM
2021/02/10,All Providers,7221,5303,1921,0,0,0,0,0,149623,117601,32114,0,0,0,0,0,11/01/2023 05:43:00 AM,11/01/2023 07:28:13 AM,11/01/2023 08:15:11 AM
2021/02/11,All Providers,7056,5147,1912,0,0,0,0,0,156679,122748,34026,0,0,0,0,0,11/01/2023 05:43:00 AM,11/01/2023 07:28:13 AM,11/01/2023 08:15:11 AM
2021/02/12,All Providers,5521,3604,1918,0,0,0,0,0,162200,126352,35944,0,0,0,0,0,11/01/2023 05:43:00 AM,11/01/2023 07:28:13 AM,11/01/2023 08:15:11 AM
2021/02/13,All Providers,4453,3087,1367,0,0,0,0,0,166653,129439,37311,0,0,0,0,0,11/01/2023 05:43:00 AM,11/01/2023 07:28:13 AM,11/01/2023 08:15:11 AM
2021/02/14,All Providers,3510,2346,1166,0,0,0,0,0,170163,131785,38477,0,0,0,0,0,11/01/2023 05:43:00 AM,11/01/2023 07:28:13 AM,11/01/2023 08:15:11 AM
2021/02/15,All Providers,2830,1692,1138,0,0,0,0,0,172993,133477,39615,0,0,0,0,0,11/01/2023 05:43:00 AM,11/01/2023 07:28:13 AM,11/01/2023 08:15:11 AM
2021/02/16,All Providers,5362,3145,2218,0,0,0,0,0,178355,136622,41833,0,0,0,0,0,11/01/2023 05:43:00 AM,11/01/2023 07:28:13 AM,11/01/2023 08:15:11 AM
2021/02/17,All Providers,5566,3106,2462,0,0,0,0,0,183921,139728,44295,0,0,0,0,0,11/01/2023 05:43:00 AM,11/01/2023 07:28:13 AM,11/01/2023 08:15:11 AM
2021/02/18,All Providers,5623,2884,2740,0,0,0,0,0,189544,142612,47035,0,0,0,0,0,11/01/2023 05:43:00 AM,11/01/2023 07:28:13 AM,11/01/2023 08:15:11 AM
2021/02/19,All Providers,5899,3074,2825,0,0,0,0,0,195443,145686,49860,0,0,0,0,0,11/01/2023 05:43:00 AM,11/01/2023 07:28:13 AM,11/01/2023 08:15:11 AM
2021/02/20,All Providers,4740,1772,2969,0,0,0,0,0,200183,147458,52829,0,0,0,0,0,11/01/2023 05:43:00 AM,11/01/2023 07:28:13 AM,11/01/2023 08:15:11 AM
2021/02/21,All Providers,3047,1325,1723,0,0,0,0,0,203230,148783,54552,0,0,0,0,0,11/01/2023 05:43:00 AM,11/01/2023 07:28:13 AM,11/01/2023 08:15:11 AM
2021/02/22,All Providers,5538,2780,2760,0,0,0,0,0,208768,151563,57312,0,0,0,0,0,11/01/2023 05:43:00 AM,11/01/2023 07:28:13 AM,11/01/2023 08:15:11 AM
2021/02/23,All Providers,6084,3078,3006,0,0,0,0,0,214852,154641,60318,0,0,0,0,0,11/01/2023 05:43:00 AM,11/01/2023 07:28:13 AM,11/01/2023 08:15:11 AM
2021/02/24,All Providers,9639,5198,4443,0,0,0,0,0,224491,159839,64761,0,0,0,0,0,11/01/2023 05:43:00 AM,11/01/2023 07:28:13 AM,11/01/2023 08:15:11 AM
2021/02/25,All Providers,10799,6867,3933,0,0,0,0,0,235290,166706,68694,0,0,0,0,0,11/01/2023 05:43:00 AM,11/01/2023 07:28:13 AM,11/01/2023 08:15:11 AM
2021/02/26,All Providers,13260,7729,5532,0,0,0,0,0,248550,174435,74226,0,0,0,0,0,11/01/2023 05:43:00 AM,11/01/2023 07:28:13 AM,11/01/2023 08:15:11 AM
2021/02/27,All Providers,10071,4862,5212,0,0,0,0,0,258621,179297,79438,0,0,0,0,0,11/01/2023 05:43:00 AM,11/01/2023 07:28:13 AM,11/01/2023 08:15:11 AM
2021/02/28,All Providers,8437,3999,4441,0,0,0,0,0,267058,183296,83879,0,0,0,0,0,11/01/2023 05:43:00 AM,11/01/2023 07:28:13 AM,11/01/2023 08:15:11 AM
2021/03/01,All Providers,12498,6089,6427,0,0,0,0,0,279556,189385,90306,0,0,0,0,0,11/01/2023 05:43:00 AM,11/01/2023 07:28:13 AM,11/01/2023 08:15:11 AM
2021/03/02,All Providers,12176,6775,5406,0,0,0,0,0,291732,196160,95712,0,0,0,0,0,11/01/2023 05:43:00 AM,11/01/2023 07:28:13 AM,11/01/2023 08:15:11 AM
2021/03/03,All Providers,12430,6707,5723,0,0,0,0,0,304162,202867,101435,0,0,0,0,0,11/01/2023 05:43:00 AM,11/01/2023 07:28:13 AM,11/01/2023 08:15:11 AM
2021/03/04,All Providers,10326,5836,4495,0,0,0,0,0,314488,208703,105930,0,0,0,0,0,11/01/2023 05:43:00 AM,11/01/2023 07:28:13 AM,11/01/2023 08:15:11 AM
2021/03/05,All Providers,10509,6459,4059,0,0,0,0,0,324997,215162,109989,0,0,0,0,0,11/01/2023 05:43:00 AM,11/01/2023 07:28:13 AM,11/01/2023 08:15:11 AM
2021/03/06,All Providers,7779,4980,3024,0,0,0,0,0,332776,220142,113013,0,0,0,0,0,11/01/2023 05:43:00 AM,11/01/2023 07:28:13 AM,11/01/2023 08:15:11 AM
2021/03/07,All Providers,6228,3680,2729,0,0,0,0,0,339004,223822,115742,0,0,0,0,0,11/01/2023 05:43:00 AM,11/01/2023 07:28:13 AM,11/01/2023 08:15:11 AM
2021/03/08,All Providers,9088,7155,2173,0,0,0,0,0,348092,230977,117915,0,0,0,0,0,11/01/2023 05:43:00 AM,11/01/2023 07:28:13 AM,11/01/2023 08:15:11 AM
2021/03/09,All Providers,9144,6938,2667,0,0,0,0,0,357236,237915,120582,0,0,0,0,0,11/01/2023 05:43:00 AM,11/01/2023 07:28:13 AM,11/01/2023 08:15:11 AM
2021/03/10,All Providers,12170,7981,4807,0,0,0,0,0,369406,245896,125389,0,0,0,0,0,11/01/2023 05:43:00 AM,11/01/2023 07:28:13 AM,11/01/2023 08:15:11 AM
2021/03/11,All Providers,10672,7930,3833,0,0,0,0,0,380078,253826,129222,0,0,0,0,0,11/01/2023 05:43:00 AM,11/01/2023 07:28:13 AM,11/01/2023 08:15:11 AM
2021/03/12,All Providers,11350,7663,5202,0,0,0,0,0,391428,261489,134424,0,0,0,0,0,11/01/2023 05:43:00 AM,11/01/2023 07:28:13 AM,11/01/2023 08:15:11 AM
2021/03/13,All Providers,6899,5291,2672,0,0,0,0,0,398327,266780,137096,0,0,0,0,0,11/01/2023 05:43:00 AM,11/01/2023 07:28:13 AM,11/01/2023 08:15:11 AM
2021/03/14,All Providers,7465,4115,3629,0,0,0,0,0,405792,270895,140725,0,0,0,0,0,11/01/2023 05:43:00 AM,11/01/2023 07:28:13 AM,11/01/2023 08:15:11 AM
2021/03/15,All Providers,12108,9156,3888,0,0,0,0,0,417900,280051,144613,0,0,0,0,0,11/01/2023 05:43:00 AM,11/01/2023 07:28:13 AM,11/01/2023 08:15:11 AM
2021/03/16,All Providers,12351,9056,3804,0,0,0,0,0,430251,289107,148417,0,0,0,0,0,11/01/2023 05:43:00 AM,11/01/2023 07:28:13 AM,11/01/2023 08:15:11 AM
2021/03/17,All Providers,13626,10132,4143,0,0,0,0,0,443877,299239,152560,0,0,0,0,0,11/01/2023 05:43:00 AM,11/01/2023 07:28:13 AM,11/01/2023 08:15:11 AM
2021/03/18,All Providers,10403,6356,4664,0,0,0,0,0,454280,305595,157224,0,0,0,0,0,11/01/2023 05:43:00 AM,11/01/2023 07:28:13 AM,11/01/2023 08:15:11 AM
2021/03/19,All Providers,12793,6955,6342,0,0,0,0,0,467073,312550,163566,0,0,0,0,0,11/01/2023 05:43:00 AM,11/01/2023 07:28:13 AM,11/01/2023 08:15:11 AM
2021/03/20,All Providers,8991,5549,3908,0,0,0,0,0,476064,318099,167474,0,0,0,0,0,11/01/2023 05:43:00 AM,11/01/2023 07:28:13 AM,11/01/2023 08:15:11 AM
2021/03/21,All Providers,6521,3611,3063,0,0,0,0,0,482585,321710,170537,0,0,0,0,0,11/01/2023 05:43:00 AM,11/01/2023 07:28:13 AM,11/01/2023 08:15:11 AM
2021/03/22,All Providers,10158,5958,5036,0,0,0,0,0,492743,327668,175573,0,0,0,0,0,11/01/2023 05:43:00 AM,11/01/2023 07:28:13 AM,11/01/2023 08:15:11 AM
2021/03/23,All Providers,11584,6516,5714,0,0,0,0,0,504327,334184,181287,0,0,0,0,0,11/01/2023 05:43:00 AM,11/01/2023 07:28:13 AM,11/01/2023 08:15:11 AM
2021/03/24,All Providers,12433,6408,6579,0,0,0,0,0,516760,340592,187866,0,0,0,0,0,11/01/2023 05:43:00 AM,11/01/2023 07:28:13 AM,11/01/2023 08:15:11 AM
2021/03/25,All Providers,12219,6036,6758,0,0,0,0,0,528979,346628,194624,0,0,0,0,0,11/01/2023 05:43:00 AM,11/01/2023 07:28:13 AM,11/01/2023 08:15:11 AM
2021/03/26,All Providers,12290,5878,6641,0,0,0,0,0,541269,352506,201265,0,0,0,0,0,11/01/2023 05:43:00 AM,11/01/2023 07:28:13 AM,11/01/2023 08:15:11 AM
2021/03/27,All Providers,9207,4235,5331,0,0,0,0,0,550476,356741,206596,0,0,0,0,0,11/01/2023 05:43:00 AM,11/01/2023 07:28:13 AM,11/01/2023 08:15:11 AM
2021/03/28,All Providers,6651,2765,3935,0,0,0,0,0,557127,359506,210531,0,0,0,0,0,11/01/2023 05:43:00 AM,11/01/2023 07:28:13 AM,11/01/2023 08:15:11 AM
2021/03/29,All Providers,11836,4447,7593,0,0,0,0,0,568963,363953,218124,0,0,0,0,0,11/01/2023 05:43:00 AM,11/01/2023 07:28:13 AM,11/01/2023 08:15:11 AM
2021/03/30,All Providers,12141,5516,6943,0,0,0,0,0,581104,369469,225067,0,0,0,0,0,11/01/2023 05:43:00 AM,11/01/2023 07:28:13 AM,11/01/2023 08:15:11 AM
2021/03/31,All Providers,12699,5265,7761,0,0,0,0,0,593803,374734,232828,0,0,0,0,0,11/01/2023 05:43:00 AM,11/01/2023 07:28:13 AM,11/01/2023 08:15:11 AM
2021/04/01,All Providers,14477,7648,8555,0,0,0,0,0,608280,382382,241383,0,0,0,0,0,11/01/2023 05:43:00 AM,11/01/2023 07:28:13 AM,11/01/2023 08:15:11 AM
2021/04/02,All Providers,15198,8731,8338,0,0,0,0,0,623478,391113,249721,0,0,0,0,0,11/01/2023 05:43:00 AM,11/01/2023 07:28:13 AM,11/01/2023 08:15:11 AM
2021/04/03,All Providers,10761,6703,5927,0,0,0,0,0,634239,397816,255648,0,0,0,0,0,11/01/2023 05:43:00 AM,11/01/2023 07:28:13 AM,11/01/2023 08:15:11 AM
2021/04/04,All Providers,8820,5031,5465,0,0,0,0,0,643059,402847,261113,0,0,0,0,0,11/01/2023 05:43:00 AM,11/01/2023 07:28:13 AM,11/01/2023 08:15:11 AM
2021/04/05,All Providers,16179,7831,10293,0,0,0,0,0,659238,410678,271406,0,0,0,0,0,11/01/2023 05:43:00 AM,11/01/2023 07:28:13 AM,11/01/2023 08:15:11 AM
2021/04/06,All Providers,16432,8317,10293,0,0,0,0,0,675670,418995,281699,0,0,0,0,0,11/01/2023 05:43:00 AM,11/01/2023 07:28:13 AM,11/01/2023 08:15:11 AM
2021/04/07,All Providers,17129,9240,10228,0,0,0,0,0,692799,428235,291927,0,0,0,0,0,11/01/2023 05:43:00 AM,11/01/2023 07:28:13 AM,11/01/2023 08:15:11 AM
2021/04/08,All Providers,14641,9216,9858,0,0,0,0,0,707440,437451,301785,0,0,0,0,0,11/01/2023 05:43:00 AM,11/01/2023 07:28:13 AM,11/01/2023 08:15:11 AM
2021/04/09,All Providers,15946,9946,9383,0,0,0,0,0,723386,447397,311168,0,0,0,0,0,11/01/2023 05:43:00 AM,11/01/2023 07:28:13 AM,11/01/2023 08:15:11 AM
2021/04/10,All Providers,13129,8728,6287,0,0,0,0,0,736515,456125,317455,0,0,0,0,0,11/01/2023 05:43:00 AM,11/01/2023 07:28:13 AM,11/01/2023 08:15:11 AM
2021/04/11,All Providers,9630,6068,4713,0,0,0,0,0,746145,462193,322168,0,0,0,0,0,11/01/2023 05:43:00 AM,11/01/2023 07:28:13 AM,11/01/2023 08:15:11 AM
2021/04/12,All Providers,10927,6179,5953,0,0,0,0,0,757072,468372,328121,0,0,0,0,0,11/01/2023 05:43:00 AM,11/01/2023 07:28:13 AM,11/01/2023 08:15:11 AM
2021/04/13,All Providers,11330,5755,5597,0,0,0,0,0,768402,474127,333718,0,0,0,0,0,11/01/2023 05:43:00 AM,11/01/2023 07:28:13 AM,11/01/2023 08:15:11 AM
2021/04/14,All Providers,13608,6469,7145,0,0,0,0,0,782010,480596,340863,0,0,0,0,0,11/01/2023 05:43:00 AM,11/01/2023 07:28:13 AM,11/01/2023 08:15:11 AM
2021/04/15,All Providers,14398,8534,5867,0,0,0,0,0,796408,489130,346730,0,0,0,0,0,11/01/2023 05:43:00 AM,11/01/2023 07:28:13 AM,11/01/2023 08:15:11 AM
2021/04/16,All Providers,13504,7884,5663,0,0,0,0,0,809912,497014,352393,0,0,0,0,0,11/01/2023 05:43:00 AM,11/01/2023 07:28:13 AM,11/01/2023 08:15:11 AM
2021/04/17,All Providers,10357,7101,3260,0,0,0,0,0,820269,504115,355653,0,0,0,0,0,11/01/2023 05:43:00 AM,11/01/2023 07:28:13 AM,11/01/2023 08:15:11 AM
2021/04/18,All Providers,7093,4454,2642,0,0,0,0,0,827362,508569,358295,0,0,0,0,0,11/01/2023 05:43:00 AM,11/01/2023 07:28:13 AM,11/01/2023 08:15:11 AM
2021/04/19,All Providers,11234,6989,4252,0,0,0,0,0,838596,515558,362547,0,0,0,0,0,11/01/2023 05:43:00 AM,11/01/2023 07:28:13 AM,11/01/2023 08:15:11 AM
2021/04/20,All Providers,13281,8748,4536,0,0,0,0,0,851877,524306,367083,0,0,0,0,0,11/01/2023 05:43:00 AM,11/01/2023 07:28:13 AM,11/01/2023 08:15:11 AM
2021/04/21,All Providers,12318,7324,5006,0,0,0,0,0,864195,531630,372089,0,0,0,0,0,11/01/2023 05:43:00 AM,11/01/2023 07:28:13 AM,11/01/2023 08:15:11 AM
2021/04/22,All Providers,11703,6529,5175,0,0,0,0,0,875898,538159,377264,0,0,0,0,0,11/01/2023 05:43:00 AM,11/01/2023 07:28:13 AM,11/01/2023 08:15:11 AM
2021/04/23,All Providers,11226,6434,4794,0,0,0,0,0,887124,544593,382058,0,0,0,0,0,11/01/2023 05:43:00 AM,11/01/2023 07:28:13 AM,11/01/2023 08:15:11 AM
2021/04/24,All Providers,8273,4702,3571,0,0,0,0,0,895397,549295,385629,0,0,0,0,0,11/01/2023 05:43:00 AM,11/01/2023 07:28:13 AM,11/01/2023 08:15:11 AM
2021/04/25,All Providers,5069,2928,2148,0,0,0,0,0,900466,552223,387777,0,0,0,0,0,11/01/2023 05:43:00 AM,11/01/2023 07:28:13 AM,11/01/2023 08:15:11 AM
2021/04/26,All Providers,8741,4255,4505,0,0,0,0,0,909207,556478,392282,0,0,0,0,0,11/01/2023 05:43:00 AM,11/01/2023 07:28:13 AM,11/01/2023 08:15:11 AM
2021/04/27,All Providers,9462,4729,4922,0,0,0,0,0,918669,561207,397204,0,0,0,0,0,11/01/2023 05:43:00 AM,11/01/2023 07:28:13 AM,11/01/2023 08:15:11 AM
2021/04/28,All Providers,10326,5362,5167,0,0,0,0,0,928995,566569,402371,0,0,0,0,0,11/01/2023 05:43:00 AM,11/01/2023 07:28:13 AM,11/01/2023 08:15:11 AM
2021/04/29,All Providers,10185,4945,5450,0,0,0,0,0,939180,571514,407821,0,0,0,0,0,11/01/2023 05:43:00 AM,11/01/2023 07:28:13 AM,11/01/2023 08:15:11 AM
2021/04/30,All Providers,11617,4374,7456,0,0,0,0,0,950797,575888,415277,0,0,0,0,0,11/01/2023 05:43:00 AM,11/01/2023 07:28:13 AM,11/01/2023 08:15:11 AM
2021/05/01,All Providers,7126,1844,5411,0,0,0,0,0,957923,577732,420688,0,0,0,0,0,11/01/2023 05:43:00 AM,11/01/2023 07:28:13 AM,11/01/2023 08:15:11 AM
2021/05/02,All Providers,5303,1095,4314,0,0,0,0,0,963226,578827,425002,0,0,0,0,0,11/01/2023 05:43:00 AM,11/01/2023 07:28:13 AM,11/01/2023 08:15:11 AM
2021/05/03,All Providers,9398,2399,7179,0,0,0,0,0,972624,581226,432181,0,0,0,0,0,11/01/2023 05:43:00 AM,11/01/2023 07:28:13 AM,11/01/2023 08:15:11 AM
2021/05/04,All Providers,9731,2518,7486,0,0,0,0,0,982355,583744,439667,0,0,0,0,0,11/01/2023 05:43:00 AM,11/01/2023 07:28:13 AM,11/01/2023 08:15:11 AM
2021/05/05,All Providers,9579,2597,7306,0,0,0,0,0,991934,586341,446973,0,0,0,0,0,11/01/2023 05:43:00 AM,11/01/2023 07:28:13 AM,11/01/2023 08:15:11 AM
2021/05/06,All Providers,11404,2375,9494,0,0,0,0,0,1003338,588716,456467,0,0,0,0,0,11/01/2023 05:43:00 AM,11/01/2023 07:28:13 AM,11/01/2023 08:15:11 AM
2021/05/07,All Providers,10633,1978,8945,0,0,0,0,0,1013971,590694,465412,0,0,0,0,0,11/01/2023 05:43:00 AM,11/01/2023 07:28:13 AM,11/01/2023 08:15:11 AM
2021/05/08,All Providers,8777,1213,7698,0,0,0,0,0,1022748,591907,473110,0,0,0,0,0,11/01/2023 05:43:00 AM,11/01/2023 07:28:13 AM,11/01/2023 08:15:11 AM
2021/05/09,All Providers,6559,1009,5635,0,0,0,0,0,1029307,592916,478745,0,0,0,0,0,11/01/2023 05:43:00 AM,11/01/2023 07:28:13 AM,11/01/2023 08:15:11 AM
2021/05/10,All Providers,7626,1253,6633,0,0,0,0,0,1036933,594169,485378,0,0,0,0,0,11/01/2023 05:43:00 AM,11/01/2023 07:28:13 AM,11/01/2023 08:15:11 AM
2021/05/11,All Providers,8690,1663,7254,0,0,0,0,0,1045623,595832,492632,0,0,0,0,0,11/01/2023 05:43:00 AM,11/01/2023 07:28:13 AM,11/01/2023 08:15:11 AM
2021/05/12,All Providers,8588,1908,7123,0,0,0,0,0,1054211,597740,499755,0,0,0,0,0,11/01/2023 05:43:00 AM,11/01/2023 07:28:13 AM,11/01/2023 08:15:11 AM
2021/05/13,All Providers,11615,4314,7517,0,0,0,0,0,1065826,602054,507272,0,0,0,0,0,11/01/2023 05:43:00 AM,11/01/2023 07:28:13 AM,11/01/2023 08:15:11 AM
2021/05/14,All Providers,9785,3129,6836,0,0,0,0,0,1075611,605183,514108,0,0,0,0,0,11/01/2023 05:43:00 AM,11/01/2023 07:28:13 AM,11/01/2023 08:15:11 AM
2021/05/15,All Providers,8220,3249,5030,0,0,0,0,0,1083831,608432,519138,0,0,0,0,0,11/01/2023 05:43:00 AM,11/01/2023 07:28:13 AM,11/01/2023 08:15:11 AM
2021/05/16,All Providers,5302,2048,3314,0,0,0,0,0,1089133,610480,522452,0,0,0,0,0,11/01/2023 05:43:00 AM,11/01/2023 07:28:13 AM,11/01/2023 08:15:11 AM
2021/05/17,All Providers,7624,2588,5216,0,0,0,0,0,1096757,613068,527668,0,0,0,0,0,11/01/2023 05:43:00 AM,11/01/2023 07:28:13 AM,11/01/2023 08:15:11 AM
2021/05/18,All Providers,8835,2004,7011,0,0,0,0,0,1105592,615072,534679,0,0,0,0,0,11/01/2023 05:43:00 AM,11/01/2023 07:28:13 AM,11/01/2023 08:15:11 AM
2021/05/19,All Providers,7627,2427,5458,0,0,0,0,0,1113219,617499,540137,0,0,0,0,0,11/01/2023 05:43:00 AM,11/01/2023 07:28:13 AM,11/01/2023 08:15:11 AM
2021/05/20,All Providers,6387,1778,4856,0,0,0,0,0,1119606,619277,544993,0,0,0,0,0,11/01/2023 05:43:00 AM,11/01/2023 07:28:13 AM,11/01/2023 08:15:11 AM
2021/05/21,All Providers,7179,1769,5602,0,0,0,0,0,1126785,621046,550595,0,0,0,0,0,11/01/2023 05:43:00 AM,11/01/2023 07:28:13 AM,11/01/2023 08:15:11 AM
2021/05/22,All Providers,4838,2266,2668,0,0,0,0,0,1131623,623312,553263,0,0,0,0,0,11/01/2023 05:43:00 AM,11/01/2023 07:28:13 AM,11/01/2023 08:15:11 AM
2021/05/23,All Providers,2027,943,1164,0,0,0,0,0,1133650,624255,554427,0,0,0,0,0,11/01/2023 05:43:00 AM,11/01/2023 07:28:13 AM,11/01/2023 08:15:11 AM
2021/05/24,All Providers,4334,1536,2980,0,0,0,0,0,1137984,625791,557407,0,0,0,0,0,11/01/2023 05:43:00 AM,11/01/2023 07:28:13 AM,11/01/2023 08:15:11 AM
2021/05/25,All Providers,3821,1344,2705,0,0,0,0,0,1141805,627135,560112,0,0,0,0,0,11/01/2023 05:43:00 AM,11/01/2023 07:28:13 AM,11/01/2023 08:15:11 AM
2021/05/26,All Providers,4118,1310,2993,0,0,0,0,0,1145923,628445,563105,0,0,0,0,0,11/01/2023 05:43:00 AM,11/01/2023 07:28:13 AM,11/01/2023 08:15:11 AM
2021/05/27,All Providers,3787,1367,2617,0,0,0,0,0,1149710,629812,565722,0,0,0,0,0,11/01/2023 05:43:00 AM,11/01/2023 07:28:13 AM,11/01/2023 08:15:11 AM
2021/05/28,All Providers,3803,1464,2509,0,0,0,0,0,1153513,631276,568231,0,0,0,0,0,11/01/2023 05:43:00 AM,11/01/2023 07:28:13 AM,11/01/2023 08:15:11 AM
2021/05/29,All Providers,2092,910,1280,0,0,0,0,0,1155605,632186,569511,0,0,0,0,0,11/01/2023 05:43:00 AM,11/01/2023 07:28:13 AM,11/01/2023 08:15:11 AM
2021/05/30,All Providers,1004,437,612,0,0,0,0,0,1156609,632623,570123,0,0,0,0,0,11/01/2023 05:43:00 AM,11/01/2023 07:28:13 AM,11/01/2023 08:15:11 AM
2021/05/31,All Providers,298,118,188,0,0,0,0,0,1156907,632741,570311,0,0,0,0,0,11/01/2023 05:43:00 AM,11/01/2023 07:28:13 AM,11/01/2023 08:15:11 AM
2021/06/01,All Providers,3687,1331,2560,0,0,0,0,0,1160594,634072,572871,0,0,0,0,0,11/01/2023 05:43:00 AM,11/01/2023 07:28:13 AM,11/01/2023 08:15:11 AM
2021/06/02,All Providers,2537,957,1702,0,0,0,0,0,1163131,635029,574573,0,0,0,0,0,11/01/2023 05:43:00 AM,11/01/2023 07:28:13 AM,11/01/2023 08:15:11 AM
2021/06/03,All Providers,3977,1130,3040,0,0,0,0,0,1167108,636159,577613,0,0,0,0,0,11/01/2023 05:43:00 AM,11/01/2023 07:28:13 AM,11/01/2023 08:15:11 AM
2021/06/04,All Providers,5723,1382,4484,0,0,0,0,0,1172831,637541,582097,0,0,0,0,0,11/01/2023 05:43:00 AM,11/01/2023 07:28:13 AM,11/01/2023 08:15:11 AM
2021/06/05,All Providers,3862,1023,2979,0,0,0,0,0,1176693,638564,585076,0,0,0,0,0,11/01/2023 05:43:00 AM,11/01/2023 07:28:13 AM,11/01/2023 08:15:11 AM
2021/06/06,All Providers,2294,417,1917,0,0,0,0,0,1178987,638981,586993,0,0,0,0,0,11/01/2023 05:43:00 AM,11/01/2023 07:28:13 AM,11/01/2023 08:15:11 AM
2021/06/07,All Providers,3749,1034,2866,0,0,0,0,0,1182736,640015,589859,0,0,0,0,0,11/01/2023 05:43:00 AM,11/01/2023 07:28:13 AM,11/01/2023 08:15:11 AM
2021/06/08,All Providers,2881,968,2072,0,0,0,0,0,1185617,640983,591931,0,0,0,0,0,11/01/2023 05:43:00 AM,11/01/2023 07:28:13 AM,11/01/2023 08:15:11 AM
2021/06/09,All Providers,2440,831,1762,0,0,0,0,0,1188057,641814,593693,0,0,0,0,0,11/01/2023 05:43:00 AM,11/01/2023 07:28:13 AM,11/01/2023 08:15:11 AM
2021/06/10,All Providers,2583,967,1814,0,0,0,0,0,1190640,642781,595507,0,0,0,0,0,11/01/2023 05:43:00 AM,11/01/2023 07:28:13 AM,11/01/2023 08:15:11 AM
2021/06/11,All Providers,3132,1080,2215,0,0,0,0,0,1193772,643861,597722,0,0,0,0,0,11/01/2023 05:43:00 AM,11/01/2023 07:28:13 AM,11/01/2023 08:15:11 AM
2021/06/12,All Providers,3097,895,2363,0,0,0,0,0,1196869,644756,600085,0,0,0,0,0,11/01/2023 05:43:00 AM,11/01/2023 07:28:13 AM,11/01/2023 08:15:11 AM
2021/06/13,All Providers,931,264,708,0,0,0,0,0,1197800,645020,600793,0,0,0,0,0,11/01/2023 05:43:00 AM,11/01/2023 07:28:13 AM,11/01/2023 08:15:11 AM
2021/06/14,All Providers,2553,986,1725,0,0,0,0,0,1200353,646006,602518,0,0,0,0,0,11/01/2023 05:43:00 AM,11/01/2023 07:28:13 AM,11/01/2023 08:15:11 AM
2021/06/15,All Providers,1963,830,1272,0,0,0,0,0,1202316,646836,603790,0,0,0,0,0,11/01/2023 05:43:00 AM,11/01/2023 07:28:13 AM,11/01/2023 08:15:11 AM
2021/06/16,All Providers,1932,849,1272,0,0,0,0,0,1204248,647685,605062,0,0,0,0,0,11/01/2023 05:43:00 AM,11/01/2023 07:28:13 AM,11/01/2023 08:15:11 AM
2021/06/17,All Providers,2015,850,1359,0,0,0,0,0,1206263,648535,606421,0,0,0,0,0,11/01/2023 05:43:00 AM,11/01/2023 07:28:13 AM,11/01/2023 08:15:11 AM
2021/06/18,All Providers,2356,922,1601,0,0,0,0,0,1208619,649457,608022,0,0,0,0,0,11/01/2023 05:43:00 AM,11/01/2023 07:28:13 AM,11/01/2023 08:15:11 AM
2021/06/19,All Providers,1443,558,999,0,0,0,0,0,1210062,650015,609021,0,0,0,0,0,11/01/2023 05:43:00 AM,11/01/2023 07:28:13 AM,11/01/2023 08:15:11 AM
2021/06/20,All Providers,650,300,384,0,0,0,0,0,1210712,650315,609405,0,0,0,0,0,11/01/2023 05:43:00 AM,11/01/2023 07:28:13 AM,11/01/2023 08:15:11 AM
2021/06/21,All Providers,1191,712,589,0,0,0,0,0,1211903,651027,609994,0,0,0,0,0,11/01/2023 05:43:00 AM,11/01/2023 07:28:13 AM,11/01/2023 08:15:11 AM
2021/06/22,All Providers,1653,687,1080,0,0,0,0,0,1213556,651714,611074,0,0,0,0,0,11/01/2023 05:43:00 AM,11/01/2023 07:28:13 AM,11/01/2023 08:15:11 AM
2021/06/23,All Providers,1518,728,925,0,0,0,0,0,1215074,652442,611999,0,0,0,0,0,11/01/2023 05:43:00 AM,11/01/2023 07:28:13 AM,11/01/2023 08:15:11 AM
2021/06/24,All Providers,1598,695,1071,0,0,0,0,0,1216672,653137,613070,0,0,0,0,0,11/01/2023 05:43:00 AM,11/01/2023 07:28:13 AM,11/01/2023 08:15:11 AM
2021/06/25,All Providers,1845,768,1178,0,0,0,0,0,1218517,653905,614248,0,0,0,0,0,11/01/2023 05:43:00 AM,11/01/2023 07:28:13 AM,11/01/2023 08:15:11 AM
2021/06/26,All Providers,1445,597,936,0,0,0,0,0,1219962,654502,615184,0,0,0,0,0,11/01/2023 05:43:00 AM,11/01/2023 07:28:13 AM,11/01/2023 08:15:11 AM
2021/06/27,All Providers,578,277,333,0,0,0,0,0,1220540,654779,615517,0,0,0,0,0,11/01/2023 05:43:00 AM,11/01/2023 07:28:13 AM,11/01/2023 08:15:11 AM
2021/06/28,All Providers,1524,633,986,0,0,0,0,0,1222064,655412,616503,0,0,0,0,0,11/01/2023 05:43:00 AM,11/01/2023 07:28:13 AM,11/01/2023 08:15:11 AM
2021/06/29,All Providers,1396,604,888,0,0,0,0,0,1223460,656016,617391,0,0,0,0,0,11/01/2023 05:43:00 AM,11/01/2023 07:28:13 AM,11/01/2023 08:15:11 AM
2021/06/30,All Providers,1343,579,838,0,0,0,0,0,1224803,656595,618229,0,0,0,0,0,11/01/2023 05:43:00 AM,11/01/2023 07:28:13 AM,11/01/2023 08:15:11 AM
2021/07/01,All Providers,1296,642,784,0,0,0,0,0,1226099,657237,619013,0,0,0,0,0,11/01/2023 05:43:00 AM,11/01/2023 07:28:13 AM,11/01/2023 08:15:11 AM
2021/07/02,All Providers,1562,714,931,0,0,0,0,0,1227661,657951,619944,0,0,0,0,0,11/01/2023 05:43:00 AM,11/01/2023 07:28:13 AM,11/01/2023 08:15:11 AM
2021/07/03,All Providers,907,415,562,0,0,0,0,0,1228568,658366,620506,0,0,0,0,0,11/01/2023 05:43:00 AM,11/01/2023 07:28:13 AM,11/01/2023 08:15:11 AM
2021/07/04,All Providers,27,14,13,0,0,0,0,0,1228595,658380,620519,0,0,0,0,0,11/01/2023 05:43:00 AM,11/01/2023 07:28:13 AM,11/01/2023 08:15:11 AM
2021/07/05,All Providers,984,441,580,0,0,0,0,0,1229579,658821,621099,0,0,0,0,0,11/01/2023 05:43:00 AM,11/01/2023 07:28:13 AM,11/01/2023 08:15:11 AM
2021/07/06,All Providers,1658,636,1114,0,0,0,0,0,1231237,659457,622213,0,0,0,0,0,11/01/2023 05:43:00 AM,11/01/2023 07:28:13 AM,11/01/2023 08:15:11 AM
2021/07/07,All Providers,1168,499,759,0,0,0,0,0,1232405,659956,622972,0,0,0,0,0,11/01/2023 05:43:00 AM,11/01/2023 07:28:13 AM,11/01/2023 08:15:11 AM
2021/07/08,All Providers,1155,531,731,0,0,0,0,0,1233560,660487,623703,0,0,0,0,0,11/01/2023 05:43:00 AM,11/01/2023 07:28:13 AM,11/01/2023 08:15:11 AM
2021/07/09,All Providers,1305,606,793,0,0,0,0,0,1234865,661093,624496,0,0,0,0,0,11/01/2023 05:43:00 AM,11/01/2023 07:28:13 AM,11/01/2023 08:15:11 AM
2021/07/10,All Providers,682,330,395,0,0,0,0,0,1235547,661423,624891,0,0,0,0,0,11/01/2023 05:43:00 AM,11/01/2023 07:28:13 AM,11/01/2023 08:15:11 AM
2021/07/11,All Providers,516,220,314,0,0,0,0,0,1236063,661643,625205,0,0,0,0,0,11/01/2023 05:43:00 AM,11/01/2023 07:28:13 AM,11/01/2023 08:15:11 AM
2021/07/12,All Providers,1313,616,787,0,0,0,0,0,1237376,662259,625992,0,0,0,0,0,11/01/2023 05:43:00 AM,11/01/2023 07:28:13 AM,11/01/2023 08:15:11 AM
2021/07/13,All Providers,985,485,573,0,0,0,0,0,1238361,662744,626565,0,0,0,0,0,11/01/2023 05:43:00 AM,11/01/2023 07:28:13 AM,11/01/2023 08:15:11 AM
2021/07/14,All Providers,1109,543,663,0,0,0,0,0,1239470,663287,627228,0,0,0,0,0,11/01/2023 05:43:00 AM,11/01/2023 07:28:13 AM,11/01/2023 08:15:11 AM
2021/07/15,All Providers,1031,535,547,0,0,0,0,0,1240501,663822,627775,0,0,0,0,0,11/01/2023 05:43:00 AM,11/01/2023 07:28:13 AM,11/01/2023 08:15:11 AM
2021/07/16,All Providers,1207,613,641,0,0,0,0,0,1241708,664435,628416,0,0,0,0,0,11/01/2023 05:43:00 AM,11/01/2023 07:28:13 AM,11/01/2023 08:15:11 AM
2021/07/17,All Providers,824,387,469,0,0,0,0,0,1242532,664822,628885,0,0,0,0,0,11/01/2023 05:43:00 AM,11/01/2023 07:28:13 AM,11/01/2023 08:15:11 AM
2021/07/18,All Providers,425,212,228,0,0,0,0,0,1242957,665034,629113,0,0,0,0,0,11/01/2023 05:43:00 AM,11/01/2023 07:28:13 AM,11/01/2023 08:15:11 AM
2021/07/19,All Providers,1223,650,640,0,0,0,0,0,1244180,665684,629753,0,0,0,0,0,11/01/2023 05:43:00 AM,11/01/2023 07:28:13 AM,11/01/2023 08:15:11 AM
2021/07/20,All Providers,938,532,478,0,0,0,0,0,1245118,666216,630231,0,0,0,0,0,11/01/2023 05:43:00 AM,11/01/2023 07:28:13 AM,11/01/2023 08:15:11 AM
2021/07/21,All Providers,1129,622,564,0,0,0,0,0,1246247,666838,630795,0,0,0,0,0,11/01/2023 05:43:00 AM,11/01/2023 07:28:13 AM,11/01/2023 08:15:11 AM
2021/07/22,All Providers,1099,602,561,0,0,0,0,0,1247346,667440,631356,0,0,0,0,0,11/01/2023 05:43:00 AM,11/01/2023 07:28:13 AM,11/01/2023 08:15:11 AM
2021/07/23,All Providers,1198,639,630,0,0,0,0,0,1248544,668079,631986,0,0,0,0,0,11/01/2023 05:43:00 AM,11/01/2023 07:28:13 AM,11/01/2023 08:15:11 AM
2021/07/24,All Providers,789,391,436,0,0,0,0,0,1249333,668470,632422,0,0,0,0,0,11/01/2023 05:43:00 AM,11/01/2023 07:28:13 AM,11/01/2023 08:15:11 AM
2021/07/25,All Providers,347,236,118,0,0,0,0,0,1249680,668706,632540,0,0,0,0,0,11/01/2023 05:43:00 AM,11/01/2023 07:28:13 AM,11/01/2023 08:15:11 AM
2021/07/26,All Providers,1173,743,517,0,0,0,0,0,1250853,669449,633057,0,0,0,0,0,11/01/2023 05:43:00 AM,11/01/2023 07:28:13 AM,11/01/2023 08:15:11 AM
2021/07/27,All Providers,1141,678,535,0,0,0,0,0,1251994,670127,633592,0,0,0,0,0,11/01/2023 05:43:00 AM,11/01/2023 07:28:13 AM,11/01/2023 08:15:11 AM
2021/07/28,All Providers,1114,697,499,0,0,0,0,0,1253108,670824,634091,0,0,0,0,0,11/01/2023 05:43:00 AM,11/01/2023 07:28:13 AM,11/01/2023 08:15:11 AM
2021/07/29,All Providers,1133,738,503,0,0,0,0,0,1254241,671562,634594,0,0,0,0,0,11/01/2023 05:43:00 AM,11/01/2023 07:28:13 AM,11/01/2023 08:15:11 AM
2021/07/30,All Providers,1220,721,597,0,0,0,0,0,1255461,672283,635191,0,0,0,0,0,11/01/2023 05:43:00 AM,11/01/2023 07:28:13 AM,11/01/2023 08:15:11 AM
2021/07/31,All Providers,758,478,319,0,0,0,0,0,1256219,672761,635510,0,0,0,0,0,11/01/2023 05:43:00 AM,11/01/2023 07:28:13 AM,11/01/2023 08:15:11 AM
2021/08/01,All Providers,408,259,166,0,0,0,0,0,1256627,673020,635676,0,0,0,0,0,11/01/2023 05:43:00 AM,11/01/2023 07:28:13 AM,11/01/2023 08:15:11 AM
2021/08/02,All Providers,1246,777,543,0,0,0,0,0,1257873,673797,636219,0,0,0,0,0,11/01/2023 05:43:00 AM,11/01/2023 07:28:13 AM,11/01/2023 08:15:11 AM
2021/08/03,All Providers,1071,656,491,0,0,0,0,0,1258944,674453,636710,0,0,0,0,0,11/01/2023 05:43:00 AM,11/01/2023 07:28:13 AM,11/01/2023 08:15:11 AM
2021/08/04,All Providers,1086,684,485,0,0,0,0,0,1260030,675137,637195,0,0,0,0,0,11/01/2023 05:43:00 AM,11/01/2023 07:28:13 AM,11/01/2023 08:15:11 AM
2021/08/05,All Providers,1143,744,500,0,0,0,0,0,1261173,675881,637695,0,0,0,0,0,11/01/2023 05:43:00 AM,11/01/2023 07:28:13 AM,11/01/2023 08:15:11 AM
2021/08/06,All Providers,1297,767,596,163,163,0,0,0,1262470,676648,638291,163,163,0,0,0,11/01/2023 05:43:00 AM,11/01/2023 07:28:13 AM,11/01/2023 08:15:11 AM
2021/08/07,All Providers,774,465,350,186,186,0,0,0,1263244,677113,638641,349,349,0,0,0,11/01/2023 05:43:00 AM,11/01/2023 07:28:13 AM,11/01/2023 08:15:11 AM
2021/08/08,All Providers,421,243,181,29,29,0,0,0,1263665,677356,638822,378,378,0,0,0,11/01/2023 05:43:00 AM,11/01/2023 07:28:13 AM,11/01/2023 08:15:11 AM
2021/08/09,All Providers,1193,698,563,196,196,0,0,0,1264858,678054,639385,574,574,0,0,0,11/01/2023 05:43:00 AM,11/01/2023 07:28:13 AM,11/01/2023 08:15:11 AM
2021/08/10,All Providers,1045,628,485,128,128,0,0,0,1265903,678682,639870,702,702,0,0,0,11/01/2023 05:43:00 AM,11/01/2023 07:28:13 AM,11/01/2023 08:15:11 AM
2021/08/11,All Providers,1117,635,539,119,119,0,0,0,1267020,679317,640409,821,821,0,0,0,11/01/2023 05:43:00 AM,11/01/2023 07:28:13 AM,11/01/2023 08:15:11 AM
2021/08/12,All Providers,1252,791,575,178,178,0,0,0,1268272,680108,640984,999,999,0,0,0,11/01/2023 05:43:00 AM,11/01/2023 07:28:13 AM,11/01/2023 08:15:11 AM
2021/08/13,All Providers,1338,806,607,228,228,0,0,0,1269610,680914,641591,1227,1227,0,0,0,11/01/2023 05:43:00 AM,11/01/2023 07:28:13 AM,11/01/2023 08:15:11 AM
2021/08/14,All Providers,908,602,353,269,269,0,0,0,1270518,681516,641944,1496,1496,0,0,0,11/01/2023 05:43:00 AM,11/01/2023 07:28:13 AM,11/01/2023 08:15:11 AM
2021/08/15,All Providers,493,297,208,179,179,0,0,0,1271011,681813,642152,1675,1675,0,0,0,11/01/2023 05:43:00 AM,11/01/2023 07:28:13 AM,11/01/2023 08:15:11 AM
2021/08/16,All Providers,1389,822,648,424,424,0,0,0,1272400,682635,642800,2099,2099,0,0,0,11/01/2023 05:43:00 AM,11/01/2023 07:28:13 AM,11/01/2023 08:15:11 AM
2021/08/17,All Providers,1230,682,636,505,505,0,0,0,1273630,683317,643436,2604,2604,0,0,0,11/01/2023 05:43:00 AM,11/01/2023 07:28:13 AM,11/01/2023 08:15:11 AM
2021/08/18,All Providers,1180,666,591,538,538,0,0,0,1274810,683983,644027,3142,3142,0,0,0,11/01/2023 05:43:00 AM,11/01/2023 07:28:13 AM,11/01/2023 08:15:11 AM
2021/08/19,All Providers,1214,694,657,565,565,0,0,0,1276024,684677,644684,3707,3707,0,0,0,11/01/2023 05:43:00 AM,11/01/2023 07:28:13 AM,11/01/2023 08:15:11 AM
2021/08/20,All Providers,1356,774,654,686,686,0,0,0,1277380,685451,645338,4393,4393,0,0,0,11/01/2023 05:43:00 AM,11/01/2023 07:28:13 AM,11/01/2023 08:15:11 AM
2021/08/21,All Providers,1006,575,484,377,377,0,0,0,1278386,686026,645822,4770,4770,0,0,0,11/01/2023 05:43:00 AM,11/01/2023 07:28:13 AM,11/01/2023 08:15:11 AM
2021/08/22,All Providers,548,331,226,185,185,0,0,0,1278934,686357,646048,4955,4955,0,0,0,11/01/2023 05:43:00 AM,11/01/2023 07:28:13 AM,11/01/2023 08:15:11 AM
2021/08/23,All Providers,1459,853,689,609,609,0,0,0,1280393,687210,646737,5564,5564,0,0,0,11/01/2023 05:43:00 AM,11/01/2023 07:28:13 AM,11/01/2023 08:15:11 AM
2021/08/24,All Providers,1211,685,603,532,532,0,0,0,1281604,687895,647340,6096,6096,0,0,0,11/01/2023 05:43:00 AM,11/01/2023 07:28:13 AM,11/01/2023 08:15:11 AM
2021/08/25,All Providers,1075,559,571,474,474,0,0,0,1282679,688454,647911,6570,6570,0,0,0,11/01/2023 05:43:00 AM,11/01/2023 07:28:13 AM,11/01/2023 08:15:11 AM
2021/08/26,All Providers,1257,691,672,572,571,0,0,0,1283936,689145,648583,7142,7141,0,0,0,11/01/2023 05:43:00 AM,11/01/2023 07:28:13 AM,11/01/2023 08:15:11 AM
2021/08/27,All Providers,1249,630,677,575,571,0,0,0,1285185,689775,649260,7717,7712,0,0,0,11/01/2023 05:43:00 AM,11/01/2023 07:28:13 AM,11/01/2023 08:15:11 AM
2021/08/28,All Providers,908,481,479,338,331,0,0,0,1286093,690256,649739,8055,8043,0,0,0,11/01/2023 05:43:00 AM,11/01/2023 07:28:13 AM,11/01/2023 08:15:11 AM
2021/08/29,All Providers,434,206,230,178,175,0,0,0,1286527,690462,649969,8233,8218,0,0,0,11/01/2023 05:43:00 AM,11/01/2023 07:28:13 AM,11/01/2023 08:15:11 AM
2021/08/30,All Providers,1201,631,631,522,520,0,0,0,1287728,691093,650600,8755,8738,0,0,0,11/01/2023 05:43:00 AM,11/01/2023 07:28:13 AM,11/01/2023 08:15:11 AM
2021/08/31,All Providers,1012,520,551,674,673,0,0,0,1288740,691613,651151,9429,9411,0,0,0,11/01/2023 05:43:00 AM,11/01/2023 07:28:13 AM,11/01/2023 08:15:11 AM
2021/09/01,All Providers,1006,512,541,575,570,0,0,0,1289746,692125,651692,10004,9981,0,0,0,11/01/2023 05:43:00 AM,11/01/2023 07:28:13 AM,11/01/2023 08:15:11 AM
2021/09/02,All Providers,1017,509,612,529,525,0,0,0,1290763,692634,652304,10533,10506,0,0,0,11/01/2023 05:43:00 AM,11/01/2023 07:28:13 AM,11/01/2023 08:15:11 AM
2021/09/03,All Providers,1186,559,685,540,532,5,0,0,1291949,693193,652989,11073,11038,5,0,0,11/01/2023 05:43:00 AM,11/01/2023 07:28:13 AM,11/01/2023 08:15:11 AM
2021/09/04,All Providers,846,361,520,259,256,0,0,0,1292795,693554,653509,11332,11294,5,0,0,11/01/2023 05:43:00 AM,11/01/2023 07:28:13 AM,11/01/2023 08:15:11 AM
2021/09/05,All Providers,407,193,219,163,162,0,0,0,1293202,693747,653728,11495,11456,5,0,0,11/01/2023 05:43:00 AM,11/01/2023 07:28:13 AM,11/01/2023 08:15:11 AM
2021/09/06,All Providers,143,76,67,25,24,1,0,0,1293345,693823,653795,11520,11480,6,0,0,11/01/2023 05:43:00 AM,11/01/2023 07:28:13 AM,11/01/2023 08:15:11 AM
2021/09/07,All Providers,1232,466,811,543,534,4,0,0,1294577,694289,654606,12063,12014,10,0,0,11/01/2023 05:43:00 AM,11/01/2023 07:28:13 AM,11/01/2023 08:15:11 AM
2021/09/08,All Providers,973,424,590,434,420,9,0,0,1295550,694713,655196,12497,12434,19,0,0,11/01/2023 05:43:00 AM,11/01/2023 07:28:13 AM,11/01/2023 08:15:11 AM
2021/09/09,All Providers,947,477,561,395,386,7,0,0,1296497,695190,655757,12892,12820,26,0,0,11/01/2023 05:43:00 AM,11/01/2023 07:28:13 AM,11/01/2023 08:15:11 AM
2021/09/10,All Providers,1077,424,691,447,437,7,0,0,1297574,695614,656448,13339,13257,33,0,0,11/01/2023 05:43:00 AM,11/01/2023 07:28:13 AM,11/01/2023 08:15:11 AM
2021/09/11,All Providers,760,309,488,205,199,5,0,0,1298334,695923,656936,13544,13456,38,0,0,11/01/2023 05:43:00 AM,11/01/2023 07:28:13 AM,11/01/2023 08:15:11 AM
2021/09/12,All Providers,452,171,285,122,119,2,0,0,1298786,696094,657221,13666,13575,40,0,0,11/01/2023 05:43:00 AM,11/01/2023 07:28:13 AM,11/01/2023 08:15:11 AM
2021/09/13,All Providers,1026,381,677,369,361,4,0,0,1299812,696475,657898,14035,13936,44,0,0,11/01/2023 05:43:00 AM,11/01/2023 07:28:13 AM,11/01/2023 08:15:11 AM
2021/09/14,All Providers,927,383,599,359,352,6,0,0,1300739,696858,658497,14394,14288,50,0,0,11/01/2023 05:43:00 AM,11/01/2023 07:28:13 AM,11/01/2023 08:15:11 AM
2021/09/15,All Providers,865,394,521,353,345,6,0,0,1301604,697252,659018,14747,14633,56,0,0,11/01/2023 05:43:00 AM,11/01/2023 07:28:13 AM,11/01/2023 08:15:11 AM
2021/09/16,All Providers,887,404,565,326,321,4,0,0,1302491,697656,659583,15073,14954,60,0,0,11/01/2023 05:43:00 AM,11/01/2023 07:28:13 AM,11/01/2023 08:15:11 AM
2021/09/17,All Providers,914,353,601,384,378,6,0,0,1303405,698009,660184,15457,15332,66,0,0,11/01/2023 05:43:00 AM,11/01/2023 07:28:13 AM,11/01/2023 08:15:11 AM
2021/09/18,All Providers,650,272,413,225,216,3,0,0,1304055,698281,660597,15682,15548,69,0,0,11/01/2023 05:43:00 AM,11/01/2023 07:28:13 AM,11/01/2023 08:15:11 AM
2021/09/19,All Providers,342,142,206,140,137,1,0,0,1304397,698423,660803,15822,15685,70,0,0,11/01/2023 05:43:00 AM,11/01/2023 07:28:13 AM,11/01/2023 08:15:11 AM
2021/09/20,All Providers,833,349,518,390,385,2,0,0,1305230,698772,661321,16212,16070,72,0,0,11/01/2023 05:43:00 AM,11/01/2023 07:28:13 AM,11/01/2023 08:15:11 AM
2021/09/21,All Providers,709,334,436,316,308,5,0,0,1305939,699106,661757,16528,16378,77,0,0,11/01/2023 05:43:00 AM,11/01/2023 07:28:13 AM,11/01/2023 08:15:11 AM
2021/09/22,All Providers,662,308,382,296,288,8,0,0,1306601,699414,662139,16824,16666,85,0,0,11/01/2023 05:43:00 AM,11/01/2023 07:28:13 AM,11/01/2023 08:15:11 AM
2021/09/23,All Providers,714,342,438,377,370,3,0,0,1307315,699756,662577,17201,17036,88,0,0,11/01/2023 05:43:00 AM,11/01/2023 07:28:13 AM,11/01/2023 08:15:11 AM
2021/09/24,All Providers,831,361,514,858,855,2,0,0,1308146,700117,663091,18059,17891,90,0,0,11/01/2023 05:43:00 AM,11/01/2023 07:28:13 AM,11/01/2023 08:15:11 AM
2021/09/25,All Providers,639,302,372,988,984,3,0,0,1308785,700419,663463,19047,18875,93,0,0,11/01/2023 05:43:00 AM,11/01/2023 07:28:13 AM,11/01/2023 08:15:11 AM
2021/09/26,All Providers,347,172,182,771,767,2,0,0,1309132,700591,663645,19818,19642,95,0,0,11/01/2023 05:43:00 AM,11/01/2023 07:28:13 AM,11/01/2023 08:15:11 AM
2021/09/27,All Providers,669,397,323,2136,2132,4,0,0,1309801,700988,663968,21954,21774,99,0,0,11/01/2023 05:43:00 AM,11/01/2023 07:28:13 AM,11/01/2023 08:15:11 AM
2021/09/28,All Providers,746,349,448,2037,2032,3,0,0,1310547,701337,664416,23991,23806,102,0,0,11/01/2023 05:43:00 AM,11/01/2023 07:28:13 AM,11/01/2023 08:15:11 AM
2021/09/29,All Providers,801,397,487,2156,2148,6,0,0,1311348,701734,664903,26147,25954,108,0,0,11/01/2023 05:43:00 AM,11/01/2023 07:28:13 AM,11/01/2023 08:15:11 AM
2021/09/30,All Providers,767,394,445,2133,2120,8,0,0,1312115,702128,665348,28280,28074,116,0,0,11/01/2023 05:43:00 AM,11/01/2023 07:28:13 AM,11/01/2023 08:15:11 AM
2021/10/01,All Providers,793,359,476,2449,2442,4,0,0,1312908,702487,665824,30729,30516,120,0,0,11/01/2023 05:43:00 AM,11/01/2023 07:28:13 AM,11/01/2023 08:15:11 AM
2021/10/02,All Providers,455,218,263,945,943,1,0,0,1313363,702705,666087,31674,31459,121,0,0,11/01/2023 05:43:00 AM,11/01/2023 07:28:13 AM,11/01/2023 08:15:11 AM
2021/10/03,All Providers,296,126,174,671,669,1,0,0,1313659,702831,666261,32345,32128,122,0,0,11/01/2023 05:43:00 AM,11/01/2023 07:28:13 AM,11/01/2023 08:15:11 AM
2021/10/04,All Providers,681,371,348,2241,2236,3,0,0,1314340,703202,666609,34586,34364,125,0,0,11/01/2023 05:43:00 AM,11/01/2023 07:28:13 AM,11/01/2023 08:15:11 AM
2021/10/05,All Providers,737,389,402,2331,2320,7,0,0,1315077,703591,667011,36917,36684,132,0,0,11/01/2023 05:43:00 AM,11/01/2023 07:28:13 AM,11/01/2023 08:15:11 AM
2021/10/06,All Providers,606,296,342,2205,2198,5,0,0,1315683,703887,667353,39122,38882,137,0,0,11/01/2023 05:43:00 AM,11/01/2023 07:28:13 AM,11/01/2023 08:15:11 AM
2021/10/07,All Providers,634,331,358,2162,2156,1,0,0,1316317,704218,667711,41284,41038,138,0,0,11/01/2023 05:43:00 AM,11/01/2023 07:28:13 AM,11/01/2023 08:15:11 AM
2021/10/08,All Providers,659,348,358,2517,2511,3,0,0,1316976,704566,668069,43801,43549,141,0,0,11/01/2023 05:43:00 AM,11/01/2023 07:28:13 AM,11/01/2023 08:15:11 AM
2021/10/09,All Providers,419,221,224,1080,1077,2,0,0,1317395,704787,668293,44881,44626,143,0,0,11/01/2023 05:43:00 AM,11/01/2023 07:28:13 AM,11/01/2023 08:15:11 AM
2021/10/10,All Providers,249,126,126,686,679,3,0,0,1317644,704913,668419,45567,45305,146,0,0,11/01/2023 05:43:00 AM,11/01/2023 07:28:13 AM,11/01/2023 08:15:11 AM
2021/10/11,All Providers,575,331,268,2319,2317,0,0,0,1318219,705244,668687,47886,47622,146,0,0,11/01/2023 05:43:00 AM,11/01/2023 07:28:13 AM,11/01/2023 08:15:11 AM
2021/10/12,All Providers,663,356,366,2655,2648,6,0,0,1318882,705600,669053,50541,50270,152,0,0,11/01/2023 05:43:00 AM,11/01/2023 07:28:13 AM,11/01/2023 08:15:11 AM
2021/10/13,All Providers,639,337,347,2410,2402,4,0,0,1319521,705937,669400,52951,52672,156,0,0,11/01/2023 05:43:00 AM,11/01/2023 07:28:13 AM,11/01/2023 08:15:11 AM
2021/10/14,All Providers,597,339,328,2136,2125,9,0,0,1320118,706276,669728,55087,54797,165,0,0,11/01/2023 05:43:00 AM,11/01/2023 07:28:13 AM,11/01/2023 08:15:11 AM
2021/10/15,All Providers,708,342,407,2700,2694,5,0,0,1320826,706618,670135,57787,57491,170,0,0,11/01/2023 05:43:00 AM,11/01/2023 07:28:13 AM,11/01/2023 08:15:11 AM
2021/10/16,All Providers,361,187,210,1057,1054,1,0,0,1321187,706805,670345,58844,58545,171,0,0,11/01/2023 05:43:00 AM,11/01/2023 07:28:13 AM,11/01/2023 08:15:11 AM
2021/10/17,All Providers,214,96,122,632,631,0,0,0,1321401,706901,670467,59476,59176,171,0,0,11/01/2023 05:43:00 AM,11/01/2023 07:28:13 AM,11/01/2023 08:15:11 AM
2021/10/18,All Providers,670,348,389,2350,2336,6,0,0,1322071,707249,670856,61826,61512,177,0,0,11/01/2023 05:43:00 AM,11/01/2023 07:28:13 AM,11/01/2023 08:15:11 AM
2021/10/19,All Providers,570,312,296,2543,2532,6,0,0,1322641,707561,671152,64369,64044,183,0,0,11/01/2023 05:43:00 AM,11/01/2023 07:28:13 AM,11/01/2023 08:15:11 AM
2021/10/20,All Providers,525,250,286,2285,2283,1,0,0,1323166,707811,671438,66654,66327,184,0,0,11/01/2023 05:43:00 AM,11/01/2023 07:28:13 AM,11/01/2023 08:15:11 AM
2021/10/21,All Providers,549,290,304,2097,2086,7,0,0,1323715,708101,671742,68751,68413,191,0,0,11/01/2023 05:43:00 AM,11/01/2023 07:28:13 AM,11/01/2023 08:15:11 AM
2021/10/22,All Providers,615,337,321,3580,3576,0,0,0,1324330,708438,672063,72331,71989,191,0,0,11/01/2023 05:43:00 AM,11/01/2023 07:28:13 AM,11/01/2023 08:15:11 AM
2021/10/23,All Providers,381,227,176,1415,1408,6,0,0,1324711,708665,672239,73746,73397,197,0,0,11/01/2023 05:43:00 AM,11/01/2023 07:28:13 AM,11/01/2023 08:15:11 AM
2021/10/24,All Providers,161,82,83,787,784,2,0,0,1324872,708747,672322,74533,74181,199,0,0,11/01/2023 05:43:00 AM,11/01/2023 07:28:13 AM,11/01/2023 08:15:11 AM
2021/10/25,All Providers,674,376,331,3482,3477,2,0,0,1325546,709123,672653,78015,77658,201,0,0,11/01/2023 05:43:00 AM,11/01/2023 07:28:13 AM,11/01/2023 08:15:11 AM
2021/10/26,All Providers,656,354,342,3847,3845,2,0,0,1326202,709477,672995,81862,81503,203,0,0,11/01/2023 05:43:00 AM,11/01/2023 07:28:13 AM,11/01/2023 08:15:11 AM
2021/10/27,All Providers,610,348,286,4020,4010,8,0,0,1326812,709825,673281,85882,85513,211,0,0,11/01/2023 05:43:00 AM,11/01/2023 07:28:13 AM,11/01/2023 08:15:11 AM
2021/10/28,All Providers,622,351,304,4124,4119,1,0,0,1327434,710176,673585,90006,89632,212,0,0,11/01/2023 05:43:00 AM,11/01/2023 07:28:13 AM,11/01/2023 08:15:11 AM
2021/10/29,All Providers,690,391,341,5246,5237,6,0,0,1328124,710567,673926,95252,94869,218,0,0,11/01/2023 05:43:00 AM,11/01/2023 07:28:13 AM,11/01/2023 08:15:11 AM
2021/10/30,All Providers,403,229,204,1968,1959,6,0,0,1328527,710796,674130,97220,96828,224,0,0,11/01/2023 05:43:00 AM,11/01/2023 07:28:13 AM,11/01/2023 08:15:11 AM
2021/10/31,All Providers,250,140,114,1151,1148,3,0,0,1328777,710936,674244,98371,97976,227,0,0,11/01/2023 05:43:00 AM,11/01/2023 07:28:13 AM,11/01/2023 08:15:11 AM
2021/11/01,All Providers,752,458,340,4528,4522,5,0,0,1329529,711394,674584,102899,102498,232,0,0,11/01/2023 05:43:00 AM,11/01/2023 07:28:13 AM,11/01/2023 08:15:11 AM
2021/11/02,All Providers,721,417,342,5112,5103,4,0,0,1330250,711811,674926,108011,107601,236,0,0,11/01/2023 05:43:00 AM,11/01/2023 07:28:13 AM,11/01/2023 08:15:11 AM
2021/11/03,All Providers,704,411,324,4803,4795,5,0,0,1330954,712222,675250,112814,112396,241,0,0,11/01/2023 05:43:00 AM,11/01/2023 07:28:13 AM,11/01/2023 08:15:11 AM
2021/11/04,All Providers,738,484,288,4939,4925,12,0,0,1331692,712706,675538,117753,117321,253,0,0,11/01/2023 05:43:00 AM,11/01/2023 07:28:13 AM,11/01/2023 08:15:11 AM
2021/11/05,All Providers,1605,1235,421,6098,6087,8,0,0,1333297,713941,675959,123851,123408,261,0,0,11/01/2023 05:43:00 AM,11/01/2023 07:28:13 AM,11/01/2023 08:15:11 AM
2021/11/06,All Providers,1897,1734,189,2434,2425,7,0,0,1335194,715675,676148,126285,125833,268,0,0,11/01/2023 05:43:00 AM,11/01/2023 07:28:13 AM,11/01/2023 08:15:11 AM
2021/11/07,All Providers,1035,950,90,1254,1252,1,0,0,1336229,716625,676238,127539,127085,269,0,0,11/01/2023 05:43:00 AM,11/01/2023 07:28:13 AM,11/01/2023 08:15:11 AM
2021/11/08,All Providers,2001,1736,306,5018,5003,8,0,0,1338230,718361,676544,132557,132088,277,0,0,11/01/2023 05:43:00 AM,11/01/2023 07:28:13 AM,11/01/2023 08:15:11 AM
2021/11/09,All Providers,1984,1710,307,4610,4599,6,0,0,1340214,720071,676851,137167,136687,283,0,0,11/01/2023 05:43:00 AM,11/01/2023 07:28:13 AM,11/01/2023 08:15:11 AM
2021/11/10,All Providers,1871,1619,274,4844,4832,11,0,0,1342085,721690,677125,142011,141519,294,0,0,11/01/2023 05:43:00 AM,11/01/2023 07:28:13 AM,11/01/2023 08:15:11 AM
2021/11/11,All Providers,1776,1586,203,4335,4326,7,0,0,1343861,723276,677328,146346,145845,301,0,0,11/01/2023 05:43:00 AM,11/01/2023 07:28:13 AM,11/01/2023 08:15:11 AM
2021/11/12,All Providers,1904,1615,314,5714,5701,10,0,0,1345765,724891,677642,152060,151546,311,0,0,11/01/2023 05:43:00 AM,11/01/2023 07:28:13 AM,11/01/2023 08:15:11 AM
2021/11/13,All Providers,2481,2346,152,2881,2875,3,0,0,1348246,727237,677794,154941,154421,314,0,0,11/01/2023 05:43:00 AM,11/01/2023 07:28:13 AM,11/01/2023 08:15:11 AM
2021/11/14,All Providers,811,750,65,1531,1527,3,0,0,1349057,727987,677859,156472,155948,317,0,0,11/01/2023 05:43:00 AM,11/01/2023 07:28:13 AM,11/01/2023 08:15:11 AM
2021/11/15,All Providers,1479,1151,363,5763,5746,11,0,0,1350536,729138,678222,162235,161694,328,0,0,11/01/2023 05:43:00 AM,11/01/2023 07:28:13 AM,11/01/2023 08:15:11 AM
2021/11/16,All Providers,1550,1235,349,6152,6140,8,0,0,1352086,730373,678571,168387,167834,336,0,0,11/01/2023 05:43:00 AM,11/01/2023 07:28:13 AM,11/01/2023 08:15:11 AM
2021/11/17,All Providers,1626,1325,331,6224,6207,8,0,0,1353712,731698,678902,174611,174041,344,0,0,11/01/2023 05:43:00 AM,11/01/2023 07:28:13 AM,11/01/2023 08:15:11 AM
2021/11/18,All Providers,1392,1099,311,6351,6332,15,0,0,1355104,732797,679213,180962,180373,359,0,0,11/01/2023 05:43:00 AM,11/01/2023 07:28:13 AM,11/01/2023 08:15:11 AM
2021/11/19,All Providers,1565,1247,351,7411,7396,10,0,0,1356669,734044,679564,188373,187769,369,0,0,11/01/2023 05:43:00 AM,11/01/2023 07:28:13 AM,11/01/2023 08:15:11 AM
2021/11/20,All Providers,1429,1250,189,3715,3704,6,0,0,1358098,735294,679753,192088,191473,375,0,0,11/01/2023 05:43:00 AM,11/01/2023 07:28:13 AM,11/01/2023 08:15:11 AM
2021/11/21,All Providers,598,485,116,1700,1695,4,0,0,1358696,735779,679869,193788,193168,379,0,0,11/01/2023 05:43:00 AM,11/01/2023 07:28:13 AM,11/01/2023 08:15:11 AM
2021/11/22,All Providers,1739,1423,343,7179,7162,13,0,0,1360435,737202,680212,200967,200330,392,0,0,11/01/2023 05:43:00 AM,11/01/2023 07:28:13 AM,11/01/2023 08:15:11 AM
2021/11/23,All Providers,1516,1184,367,7355,7339,9,0,0,1361951,738386,680579,208322,207669,401,0,0,11/01/2023 05:43:00 AM,11/01/2023 07:28:13 AM,11/01/2023 08:15:11 AM
2021/11/24,All Providers,1332,1024,334,6124,6102,13,0,0,1363283,739410,680913,214446,213771,414,0,0,11/01/2023 05:43:00 AM,11/01/2023 07:28:13 AM,11/01/2023 08:15:11 AM
2021/11/25,All Providers,131,56,79,209,207,2,0,0,1363414,739466,680992,214655,213978,416,0,0,11/01/2023 05:43:00 AM,11/01/2023 07:28:13 AM,11/01/2023 08:15:11 AM
2021/11/26,All Providers,635,363,274,3491,3480,8,0,0,1364049,739829,681266,218146,217458,424,0,0,11/01/2023 05:43:00 AM,11/01/2023 07:28:13 AM,11/01/2023 08:15:11 AM
2021/11/27,All Providers,1505,496,1015,2674,2663,6,0,0,1365554,740325,682281,220820,220121,430,0,0,11/01/2023 05:43:00 AM,11/01/2023 07:28:13 AM,11/01/2023 08:15:11 AM
2021/11/28,All Providers,1360,265,1104,1482,1480,1,0,0,1366914,740590,683385,222302,221601,431,0,0,11/01/2023 05:43:00 AM,11/01/2023 07:28:13 AM,11/01/2023 08:15:11 AM
2021/11/29,All Providers,2034,737,1330,6332,6315,9,0,0,1368948,741327,684715,228634,227916,440,0,0,11/01/2023 05:43:00 AM,11/01/2023 07:28:13 AM,11/01/2023 08:15:11 AM
2021/11/30,All Providers,2244,753,1531,6705,6687,17,0,0,1371192,742080,686246,235339,234603,457,0,0,11/01/2023 05:43:00 AM,11/01/2023 07:28:13 AM,11/01/2023 08:15:11 AM
2021/12/01,All Providers,2223,819,1433,7172,7152,14,0,0,1373415,742899,687679,242511,241755,471,0,0,11/01/2023 05:43:00 AM,11/01/2023 07:28:13 AM,11/01/2023 08:15:11 AM
2021/12/02,All Providers,2306,784,1556,7193,7180,10,0,0,1375721,743683,689235,249704,248935,481,0,0,11/01/2023 05:43:00 AM,11/01/2023 07:28:13 AM,11/01/2023 08:15:11 AM
2021/12/03,All Providers,2579,825,1775,7623,7605,14,0,0,1378300,744508,691010,257327,256540,495,0,0,11/01/2023 05:43:00 AM,11/01/2023 07:28:13 AM,11/01/2023 08:15:11 AM
2021/12/04,All Providers,2924,705,2235,3765,3752,13,0,0,1381224,745213,693245,261092,260292,508,0,0,11/01/2023 05:43:00 AM,11/01/2023 07:28:13 AM,11/01/2023 08:15:11 AM
2021/12/05,All Providers,876,297,580,1687,1684,2,0,0,1382100,745510,693825,262779,261976,510,0,0,11/01/2023 05:43:00 AM,11/01/2023 07:28:13 AM,11/01/2023 08:15:11 AM
2021/12/06,All Providers,1955,832,1152,7062,7043,13,0,0,1384055,746342,694977,269841,269019,523,0,0,11/01/2023 05:43:00 AM,11/01/2023 07:28:13 AM,11/01/2023 08:15:11 AM
2021/12/07,All Providers,1998,917,1108,7446,7427,16,0,0,1386053,747259,696085,277287,276446,539,0,0,11/01/2023 05:43:00 AM,11/01/2023 07:28:13 AM,11/01/2023 08:15:11 AM
2021/12/08,All Providers,2059,882,1206,7235,7221,11,0,0,1388112,748141,697291,284522,283667,550,0,0,11/01/2023 05:43:00 AM,11/01/2023 07:28:13 AM,11/01/2023 08:15:11 AM
2021/12/09,All Providers,1771,819,981,6841,6817,19,0,0,1389883,748960,698272,291363,290484,569,0,0,11/01/2023 05:43:00 AM,11/01/2023 07:28:13 AM,11/01/2023 08:15:11 AM
2021/12/10,All Providers,1917,844,1097,7312,7298,10,0,0,1391800,749804,699369,298675,297782,579,0,0,11/01/2023 05:43:00 AM,11/01/2023 07:28:13 AM,11/01/2023 08:15:11 AM
2021/12/11,All Providers,1939,634,1326,3472,3461,9,0,0,1393739,750438,700695,302147,301243,588,0,0,11/01/2023 05:43:00 AM,11/01/2023 07:28:13 AM,11/01/2023 08:15:11 AM
2021/12/12,All Providers,640,260,381,1606,1600,6,0,0,1394379,750698,701076,303753,302843,594,0,0,11/01/2023 05:43:00 AM,11/01/2023 07:28:13 AM,11/01/2023 08:15:11 AM
2021/12/13,All Providers,1600,656,956,6015,5995,18,0,0,1395979,751354,702032,309768,308838,612,0,0,11/01/2023 05:43:00 AM,11/01/2023 07:28:13 AM,11/01/2023 08:15:11 AM
2021/12/14,All Providers,1646,794,874,6511,6495,15,0,0,1397625,752148,702906,316279,315333,627,0,0,11/01/2023 05:43:00 AM,11/01/2023 07:28:13 AM,11/01/2023 08:15:11 AM
2021/12/15,All Providers,1600,718,907,6333,6313,18,0,0,1399225,752866,703813,322612,321646,645,0,0,11/01/2023 05:43:00 AM,11/01/2023 07:28:13 AM,11/01/2023 08:15:11 AM
2021/12/16,All Providers,1298,787,533,6746,6717,27,0,0,1400523,753653,704346,329358,328363,672,0,0,11/01/2023 05:43:00 AM,11/01/2023 07:28:13 AM,11/01/2023 08:15:11 AM
2021/12/17,All Providers,1514,841,686,7022,6988,24,0,0,1402037,754494,705032,336380,335351,696,0,0,11/01/2023 05:43:00 AM,11/01/2023 07:28:13 AM,11/01/2023 08:15:11 AM
2021/12/18,All Providers,1304,670,646,3892,3866,23,0,0,1403341,755164,705678,340272,339217,719,0,0,11/01/2023 05:43:00 AM,11/01/2023 07:28:13 AM,11/01/2023 08:15:11 AM
2021/12/19,All Providers,551,309,244,2189,2183,6,0,0,1403892,755473,705922,342461,341400,725,0,0,11/01/2023 05:43:00 AM,11/01/2023 07:28:13 AM,11/01/2023 08:15:11 AM
2021/12/20,All Providers,1546,902,658,6958,6928,28,0,0,1405438,756375,706580,349419,348328,753,0,0,11/01/2023 05:43:00 AM,11/01/2023 07:28:13 AM,11/01/2023 08:15:11 AM
2021/12/21,All Providers,1553,939,638,7014,6987,19,0,0,1406991,757314,707218,356433,355315,772,0,0,11/01/2023 05:43:00 AM,11/01/2023 07:28:13 AM,11/01/2023 08:15:11 AM
2021/12/22,All Providers,1428,817,625,6928,6895,30,0,0,1408419,758131,707843,363361,362210,802,0,0,11/01/2023 05:43:00 AM,11/01/2023 07:28:13 AM,11/01/2023 08:15:11 AM
2021/12/23,All Providers,1208,778,445,5930,5897,26,0,0,1409627,758909,708288,369291,368107,828,0,0,11/01/2023 05:43:00 AM,11/01/2023 07:28:13 AM,11/01/2023 08:15:11 AM
2021/12/24,All Providers,339,208,139,1705,1698,6,0,0,1409966,759117,708427,370996,369805,834,0,0,11/01/2023 05:43:00 AM,11/01/2023 07:28:13 AM,11/01/2023 08:15:11 AM
2021/12/25,All Providers,5,1,4,8,8,0,0,0,1409971,759118,708431,371004,369813,834,0,0,11/01/2023 05:43:00 AM,11/01/2023 07:28:13 AM,11/01/2023 08:15:11 AM
2021/12/26,All Providers,359,199,161,1046,1035,11,0,0,1410330,759317,708592,372050,370848,845,0,0,11/01/2023 05:43:00 AM,11/01/2023 07:28:13 AM,11/01/2023 08:15:11 AM
2021/12/27,All Providers,1455,772,692,5316,5286,24,0,0,1411785,760089,709284,377366,376134,869,0,0,11/01/2023 05:43:00 AM,11/01/2023 07:28:13 AM,11/01/2023 08:15:11 AM
2021/12/28,All Providers,1365,767,611,5626,5576,42,0,0,1413150,760856,709895,382992,381710,911,0,0,11/01/2023 05:43:00 AM,11/01/2023 07:28:13 AM,11/01/2023 08:15:11 AM
2021/12/29,All Providers,1316,799,529,5409,5381,23,0,0,1414466,761655,710424,388401,387091,934,0,0,11/01/2023 05:43:00 AM,11/01/2023 07:28:13 AM,11/01/2023 08:15:11 AM
2021/12/30,All Providers,1298,777,532,5198,5167,24,0,0,1415764,762432,710956,393599,392258,958,0,0,11/01/2023 05:43:00 AM,11/01/2023 07:28:13 AM,11/01/2023 08:15:11 AM
2021/12/31,All Providers,427,244,189,1898,1881,15,0,0,1416191,762676,711145,395497,394139,973,0,0,11/01/2023 05:43:00 AM,11/01/2023 07:28:13 AM,11/01/2023 08:15:11 AM
2022/01/01,All Providers,59,17,43,42,40,1,0,0,1416250,762693,711188,395539,394179,974,0,0,11/01/2023 05:43:00 AM,11/01/2023 07:28:13 AM,11/01/2023 08:15:11 AM
2022/01/02,All Providers,422,174,250,992,980,10,0,0,1416672,762867,711438,396531,395159,984,0,0,11/01/2023 05:43:00 AM,11/01/2023 07:28:13 AM,11/01/2023 08:15:11 AM
2022/01/03,All Providers,1231,678,566,4336,4298,34,0,0,1417903,763545,712004,400867,399457,1018,0,0,11/01/2023 05:43:00 AM,11/01/2023 07:28:13 AM,11/01/2023 08:15:11 AM
2022/01/04,All Providers,1092,620,488,4633,4603,28,0,0,1418995,764165,712492,405500,404060,1046,0,0,11/01/2023 05:43:00 AM,11/01/2023 07:28:13 AM,11/01/2023 08:15:11 AM
2022/01/05,All Providers,1186,717,477,4456,4406,42,0,0,1420181,764882,712969,409956,408466,1088,0,0,11/01/2023 05:43:00 AM,11/01/2023 07:28:13 AM,11/01/2023 08:15:11 AM
2022/01/06,All Providers,1291,759,545,4798,4765,23,0,0,1421472,765641,713514,414754,413231,1111,0,0,11/01/2023 05:43:00 AM,11/01/2023 07:28:13 AM,11/01/2023 08:15:11 AM
2022/01/07,All Providers,1325,755,582,5570,5527,41,0,0,1422797,766396,714096,420324,418758,1152,0,0,11/01/2023 05:43:00 AM,11/01/2023 07:28:13 AM,11/01/2023 08:15:11 AM
2022/01/08,All Providers,1003,491,517,3085,3063,20,0,0,1423800,766887,714613,423409,421821,1172,0,0,11/01/2023 05:43:00 AM,11/01/2023 07:28:13 AM,11/01/2023 08:15:11 AM
2022/01/09,All Providers,362,199,163,1109,1097,11,0,0,1424162,767086,714776,424518,422918,1183,0,0,11/01/2023 05:43:00 AM,11/01/2023 07:28:13 AM,11/01/2023 08:15:11 AM
2022/01/10,All Providers,1065,635,438,4445,4412,31,0,0,1425227,767721,715214,428963,427330,1214,0,0,11/01/2023 05:43:00 AM,11/01/2023 07:28:13 AM,11/01/2023 08:15:11 AM
2022/01/11,All Providers,1120,664,474,4459,4424,32,0,0,1426347,768385,715688,433422,431754,1246,0,0,11/01/2023 05:43:00 AM,11/01/2023 07:28:13 AM,11/01/2023 08:15:11 AM
2022/01/12,All Providers,1151,671,495,4439,4398,36,0,0,1427498,769056,716183,437861,436152,1282,0,0,11/01/2023 05:43:00 AM,11/01/2023 07:28:13 AM,11/01/2023 08:15:11 AM
2022/01/13,All Providers,1017,584,440,4118,4079,36,0,0,1428515,769640,716623,441979,440231,1318,0,0,11/01/2023 05:43:00 AM,11/01/2023 07:28:13 AM,11/01/2023 08:15:11 AM
2022/01/14,All Providers,1080,696,395,4550,4492,50,0,0,1429595,770336,717018,446529,444723,1368,0,0,11/01/2023 05:43:00 AM,11/01/2023 07:28:13 AM,11/01/2023 08:15:11 AM
2022/01/15,All Providers,577,372,206,2410,2387,20,0,0,1430172,770708,717224,448939,447110,1388,0,0,11/01/2023 05:43:00 AM,11/01/2023 07:28:13 AM,11/01/2023 08:15:11 AM
2022/01/16,All Providers,259,164,96,1008,996,11,0,0,1430431,770872,717320,449947,448106,1399,0,0,11/01/2023 05:43:00 AM,11/01/2023 07:28:13 AM,11/01/2023 08:15:11 AM
2022/01/17,All Providers,667,448,224,2896,2865,29,0,0,1431098,771320,717544,452843,450971,1428,0,0,11/01/2023 05:43:00 AM,11/01/2023 07:28:13 AM,11/01/2023 08:15:11 AM
2022/01/18,All Providers,929,517,423,3379,3334,39,0,0,1432027,771837,717967,456222,454305,1467,0,0,11/01/2023 05:43:00 AM,11/01/2023 07:28:13 AM,11/01/2023 08:15:11 AM
2022/01/19,All Providers,950,541,415,3370,3335,33,0,0,1432977,772378,718382,459592,457640,1500,0,0,11/01/2023 05:43:00 AM,11/01/2023 07:28:13 AM,11/01/2023 08:15:11 AM
2022/01/20,All Providers,864,494,381,3122,3069,50,0,0,1433841,772872,718763,462714,460709,1550,0,0,11/01/2023 05:43:00 AM,11/01/2023 07:28:13 AM,11/01/2023 08:15:11 AM
2022/01/21,All Providers,844,509,341,3387,3313,67,0,0,1434685,773381,719104,466101,464022,1617,0,0,11/01/2023 05:43:00 AM,11/01/2023 07:28:13 AM,11/01/2023 08:15:11 AM
2022/01/22,All Providers,547,356,193,1705,1676,25,0,0,1435232,773737,719297,467806,465698,1642,0,0,11/01/2023 05:43:00 AM,11/01/2023 07:28:13 AM,11/01/2023 08:15:11 AM
2022/01/23,All Providers,228,138,91,879,859,18,0,0,1435460,773875,719388,468685,466557,1660,0,0,11/01/2023 05:43:00 AM,11/01/2023 07:28:13 AM,11/01/2023 08:15:11 AM
2022/01/24,All Providers,817,485,343,2797,2729,65,0,0,1436277,774360,719731,471482,469286,1725,0,0,11/01/2023 05:43:00 AM,11/01/2023 07:28:13 AM,11/01/2023 08:15:11 AM
2022/01/25,All Providers,785,463,333,2920,2860,58,0,0,1437062,774823,720064,474402,472146,1783,0,0,11/01/2023 05:43:00 AM,11/01/2023 07:28:13 AM,11/01/2023 08:15:11 AM
2022/01/26,All Providers,857,444,424,2708,2641,67,0,0,1437919,775267,720488,477110,474787,1850,0,0,11/01/2023 05:43:00 AM,11/01/2023 07:28:13 AM,11/01/2023 08:15:11 AM
2022/01/27,All Providers,781,410,378,2563,2485,75,0,0,1438700,775677,720866,479673,477272,1925,0,0,11/01/2023 05:43:00 AM,11/01/2023 07:28:13 AM,11/01/2023 08:15:11 AM
2022/01/28,All Providers,927,491,445,2893,2798,90,0,0,1439627,776168,721311,482566,480070,2015,0,0,11/01/2023 05:43:00 AM,11/01/2023 07:28:13 AM,11/01/2023 08:15:11 AM
2022/01/29,All Providers,631,312,326,1605,1534,70,0,0,1440258,776480,721637,484171,481604,2085,0,0,11/01/2023 05:43:00 AM,11/01/2023 07:28:13 AM,11/01/2023 08:15:11 AM
2022/01/30,All Providers,242,117,125,660,638,19,0,0,1440500,776597,721762,484831,482242,2104,0,0,11/01/2023 05:43:00 AM,11/01/2023 07:28:13 AM,11/01/2023 08:15:11 AM
2022/01/31,All Providers,679,365,324,2013,1919,93,0,0,1441179,776962,722086,486844,484161,2197,0,0,11/01/2023 05:43:00 AM,11/01/2023 07:28:13 AM,11/01/2023 08:15:11 AM
2022/02/01,All Providers,619,302,325,1697,1615,80,0,0,1441798,777264,722411,488541,485776,2277,0,0,11/01/2023 05:43:00 AM,11/01/2023 07:28:13 AM,11/01/2023 08:15:11 AM
2022/02/02,All Providers,675,311,376,1669,1579,88,0,0,1442473,777575,722787,490210,487355,2365,0,0,11/01/2023 05:43:00 AM,11/01/2023 07:28:13 AM,11/01/2023 08:15:11 AM
2022/02/03,All Providers,592,296,306,1578,1509,68,0,0,1443065,777871,723093,491788,488864,2433,0,0,11/01/2023 05:43:00 AM,11/01/2023 07:28:13 AM,11/01/2023 08:15:11 AM
2022/02/04,All Providers,843,405,447,1954,1829,123,0,0,1443908,778276,723540,493742,490693,2556,0,0,11/01/2023 05:43:00 AM,11/01/2023 07:28:13 AM,11/01/2023 08:15:11 AM
2022/02/05,All Providers,535,274,263,900,835,63,0,0,1444443,778550,723803,494642,491528,2619,0,0,11/01/2023 05:43:00 AM,11/01/2023 07:28:13 AM,11/01/2023 08:15:11 AM
2022/02/06,All Providers,207,126,81,507,481,25,0,0,1444650,778676,723884,495149,492009,2644,0,0,11/01/2023 05:43:00 AM,11/01/2023 07:28:13 AM,11/01/2023 08:15:11 AM
2022/02/07,All Providers,549,275,283,1456,1351,103,0,0,1445199,778951,724167,496605,493360,2747,0,0,11/01/2023 05:43:00 AM,11/01/2023 07:28:13 AM,11/01/2023 08:15:11 AM
2022/02/08,All Providers,533,292,255,1277,1196,78,0,0,1445732,779243,724422,497882,494556,2825,0,0,11/01/2023 05:43:00 AM,11/01/2023 07:28:13 AM,11/01/2023 08:15:11 AM
2022/02/09,All Providers,608,276,335,1280,1198,79,0,0,1446340,779519,724757,499162,495754,2904,0,0,11/01/2023 05:43:00 AM,11/01/2023 07:28:13 AM,11/01/2023 08:15:11 AM
2022/02/10,All Providers,465,243,229,1121,1035,80,0,0,1446805,779762,724986,500283,496789,2984,0,0,11/01/2023 05:43:00 AM,11/01/2023 07:28:13 AM,11/01/2023 08:15:11 AM
2022/02/11,All Providers,592,284,311,1434,1315,115,0,0,1447397,780046,725297,501717,498104,3099,0,0,11/01/2023 05:43:00 AM,11/01/2023 07:28:13 AM,11/01/2023 08:15:11 AM
2022/02/12,All Providers,406,201,208,656,614,38,0,0,1447803,780247,725505,502373,498718,3137,0,0,11/01/2023 05:43:00 AM,11/01/2023 07:28:13 AM,11/01/2023 08:15:11 AM
2022/02/13,All Providers,131,87,44,294,273,20,0,0,1447934,780334,725549,502667,498991,3157,0,0,11/01/2023 05:43:00 AM,11/01/2023 07:28:13 AM,11/01/2023 08:15:11 AM
2022/02/14,All Providers,320,163,159,830,740,88,0,0,1448254,780497,725708,503497,499731,3245,0,0,11/01/2023 05:43:00 AM,11/01/2023 07:28:13 AM,11/01/2023 08:15:11 AM
2022/02/15,All Providers,390,170,228,810,724,82,0,0,1448644,780667,725936,504307,500455,3327,0,0,11/01/2023 05:43:00 AM,11/01/2023 07:28:13 AM,11/01/2023 08:15:11 AM
2022/02/16,All Providers,419,191,234,1067,979,83,0,0,1449063,780858,726170,505374,501434,3410,0,0,11/01/2023 05:43:00 AM,11/01/2023 07:28:13 AM,11/01/2023 08:15:11 AM
2022/02/17,All Providers,424,198,230,1005,916,87,0,0,1449487,781056,726400,506379,502350,3497,0,0,11/01/2023 05:43:00 AM,11/01/2023 07:28:13 AM,11/01/2023 08:15:11 AM
2022/02/18,All Providers,531,249,286,1196,1062,131,0,0,1450018,781305,726686,507575,503412,3628,0,0,11/01/2023 05:43:00 AM,11/01/2023 07:28:13 AM,11/01/2023 08:15:11 AM
2022/02/19,All Providers,291,145,147,624,579,43,0,0,1450309,781450,726833,508199,503991,3671,0,0,11/01/2023 05:43:00 AM,11/01/2023 07:28:13 AM,11/01/2023 08:15:11 AM
2022/02/20,All Providers,124,67,57,306,266,37,0,0,1450433,781517,726890,508505,504257,3708,0,0,11/01/2023 05:43:00 AM,11/01/2023 07:28:13 AM,11/01/2023 08:15:11 AM
2022/02/21,All Providers,230,115,118,524,464,58,0,0,1450663,781632,727008,509029,504721,3766,0,0,11/01/2023 05:43:00 AM,11/01/2023 07:28:13 AM,11/01/2023 08:15:11 AM
2022/02/22,All Providers,324,151,176,821,722,91,0,0,1450987,781783,727184,509850,505443,3857,0,0,11/01/2023 05:43:00 AM,11/01/2023 07:28:13 AM,11/01/2023 08:15:11 AM
2022/02/23,All Providers,332,162,174,840,756,82,0,0,1451319,781945,727358,510690,506199,3939,0,0,11/01/2023 05:43:00 AM,11/01/2023 07:28:13 AM,11/01/2023 08:15:11 AM
2022/02/24,All Providers,381,217,169,780,697,81,0,0,1451700,782162,727527,511470,506896,4020,0,0,11/01/2023 05:43:00 AM,11/01/2023 07:28:13 AM,11/01/2023 08:15:11 AM
2022/02/25,All Providers,482,276,213,1048,947,99,0,0,1452182,782438,727740,512518,507843,4119,0,0,11/01/2023 05:43:00 AM,11/01/2023 07:28:13 AM,11/01/2023 08:15:11 AM
2022/02/26,All Providers,232,128,109,522,483,38,0,0,1452414,782566,727849,513040,508326,4157,0,0,11/01/2023 05:43:00 AM,11/01/2023 07:28:13 AM,11/01/2023 08:15:11 AM
2022/02/27,All Providers,113,62,51,226,208,18,0,0,1452527,782628,727900,513266,508534,4175,0,0,11/01/2023 05:43:00 AM,11/01/2023 07:28:13 AM,11/01/2023 08:15:11 AM
2022/02/28,All Providers,308,175,138,843,758,81,0,0,1452835,782803,728038,514109,509292,4256,0,0,11/01/2023 05:43:00 AM,11/01/2023 07:28:13 AM,11/01/2023 08:15:11 AM
2022/03/01,All Providers,233,127,118,637,550,82,0,0,1453068,782930,728156,514746,509842,4338,0,0,11/01/2023 05:43:00 AM,11/01/2023 07:28:13 AM,11/01/2023 08:15:11 AM
2022/03/02,All Providers,246,123,124,601,524,76,0,0,1453314,783053,728280,515347,510366,4414,0,0,11/01/2023 05:43:00 AM,11/01/2023 07:28:13 AM,11/01/2023 08:15:11 AM
2022/03/03,All Providers,230,148,90,630,540,87,0,0,1453544,783201,728370,515977,510906,4501,0,0,11/01/2023 05:43:00 AM,11/01/2023 07:28:13 AM,11/01/2023 08:15:11 AM
2022/03/04,All Providers,364,193,177,772,673,97,0,0,1453908,783394,728547,516749,511579,4598,0,0,11/01/2023 05:43:00 AM,11/01/2023 07:28:13 AM,11/01/2023 08:15:11 AM
2022/03/05,All Providers,206,112,94,360,332,28,0,0,1454114,783506,728641,517109,511911,4626,0,0,11/01/2023 05:43:00 AM,11/01/2023 07:28:13 AM,11/01/2023 08:15:11 AM
2022/03/06,All Providers,91,50,41,155,138,17,0,0,1454205,783556,728682,517264,512049,4643,0,0,11/01/2023 05:43:00 AM,11/01/2023 07:28:13 AM,11/01/2023 08:15:11 AM
2022/03/07,All Providers,244,152,96,559,470,89,0,0,1454449,783708,728778,517823,512519,4732,0,0,11/01/2023 05:43:00 AM,11/01/2023 07:28:13 AM,11/01/2023 08:15:11 AM
2022/03/08,All Providers,208,119,89,493,429,63,0,0,1454657,783827,728867,518316,512948,4795,0,0,11/01/2023 05:43:00 AM,11/01/2023 07:28:13 AM,11/01/2023 08:15:11 AM
2022/03/09,All Providers,244,142,109,524,434,89,0,0,1454901,783969,728976,518840,513382,4884,0,0,11/01/2023 05:43:00 AM,11/01/2023 07:28:13 AM,11/01/2023 08:15:11 AM
2022/03/10,All Providers,263,124,143,542,454,87,0,0,1455164,784093,729119,519382,513836,4971,0,0,11/01/2023 05:43:00 AM,11/01/2023 07:28:13 AM,11/01/2023 08:15:11 AM
2022/03/11,All Providers,345,189,158,640,548,87,0,0,1455509,784282,729277,520022,514384,5058,0,0,11/01/2023 05:43:00 AM,11/01/2023 07:28:13 AM,11/01/2023 08:15:11 AM
2022/03/12,All Providers,188,101,89,313,273,35,0,0,1455697,784383,729366,520335,514657,5093,0,0,11/01/2023 05:43:00 AM,11/01/2023 07:28:13 AM,11/01/2023 08:15:11 AM
2022/03/13,All Providers,79,46,36,147,137,10,0,0,1455776,784429,729402,520482,514794,5103,0,0,11/01/2023 05:43:00 AM,11/01/2023 07:28:13 AM,11/01/2023 08:15:11 AM
2022/03/14,All Providers,187,112,78,474,385,88,0,0,1455963,784541,729480,520956,515179,5191,0,0,11/01/2023 05:43:00 AM,11/01/2023 07:28:13 AM,11/01/2023 08:15:11 AM
2022/03/15,All Providers,189,105,92,492,408,82,0,0,1456152,784646,729572,521448,515587,5273,0,0,11/01/2023 05:43:00 AM,11/01/2023 07:28:13 AM,11/01/2023 08:15:11 AM
2022/03/16,All Providers,201,109,97,476,361,110,0,0,1456353,784755,729669,521924,515948,5383,0,0,11/01/2023 05:43:00 AM,11/01/2023 07:28:13 AM,11/01/2023 08:15:11 AM
2022/03/17,All Providers,236,127,116,501,387,109,0,0,1456589,784882,729785,522425,516335,5492,0,0,11/01/2023 05:43:00 AM,11/01/2023 07:28:13 AM,11/01/2023 08:15:11 AM
2022/03/18,All Providers,304,169,139,610,460,144,0,0,1456893,785051,729924,523035,516795,5636,0,0,11/01/2023 05:43:00 AM,11/01/2023 07:28:13 AM,11/01/2023 08:15:11 AM
2022/03/19,All Providers,182,103,79,282,212,69,0,0,1457075,785154,730003,523317,517007,5705,0,0,11/01/2023 05:43:00 AM,11/01/2023 07:28:13 AM,11/01/2023 08:15:11 AM
2022/03/20,All Providers,89,55,35,194,134,58,0,0,1457164,785209,730038,523511,517141,5763,0,0,11/01/2023 05:43:00 AM,11/01/2023 07:28:13 AM,11/01/2023 08:15:11 AM
2022/03/21,All Providers,197,119,79,477,338,137,0,0,1457361,785328,730117,523988,517479,5900,0,0,11/01/2023 05:43:00 AM,11/01/2023 07:28:13 AM,11/01/2023 08:15:11 AM
2022/03/22,All Providers,156,93,67,399,289,104,0,0,1457517,785421,730184,524387,517768,6004,0,0,11/01/2023 05:43:00 AM,11/01/2023 07:28:13 AM,11/01/2023 08:15:11 AM
2022/03/23,All Providers,184,97,91,462,341,119,0,0,1457701,785518,730275,524849,518109,6123,0,0,11/01/2023 05:43:00 AM,11/01/2023 07:28:13 AM,11/01/2023 08:15:11 AM
2022/03/24,All Providers,191,114,82,474,343,131,0,0,1457892,785632,730357,525323,518452,6254,0,0,11/01/2023 05:43:00 AM,11/01/2023 07:28:13 AM,11/01/2023 08:15:11 AM
2022/03/25,All Providers,209,114,98,495,374,120,0,0,1458101,785746,730455,525818,518826,6374,0,0,11/01/2023 05:43:00 AM,11/01/2023 07:28:13 AM,11/01/2023 08:15:11 AM
2022/03/26,All Providers,142,82,61,261,199,61,0,0,1458243,785828,730516,526079,519025,6435,0,0,11/01/2023 05:43:00 AM,11/01/2023 07:28:13 AM,11/01/2023 08:15:11 AM
2022/03/27,All Providers,78,50,28,195,134,61,0,0,1458321,785878,730544,526274,519159,6496,0,0,11/01/2023 05:43:00 AM,11/01/2023 07:28:13 AM,11/01/2023 08:15:11 AM
2022/03/28,All Providers,196,103,96,504,361,141,0,0,1458517,785981,730640,526778,519520,6637,0,0,11/01/2023 05:43:00 AM,11/01/2023 07:28:13 AM,11/01/2023 08:15:11 AM
2022/03/29,All Providers,159,89,74,695,349,342,0,0,1458676,786070,730714,527473,519869,6979,0,0,11/01/2023 05:43:00 AM,11/01/2023 07:28:13 AM,11/01/2023 08:15:11 AM
2022/03/30,All Providers,173,87,87,1293,403,885,0,0,1458849,786157,730801,528766,520272,7864,0,0,11/01/2023 05:43:00 AM,11/01/2023 07:28:13 AM,11/01/2023 08:15:11 AM
2022/03/31,All Providers,212,106,110,1796,495,1294,0,0,1459061,786263,730911,530562,520767,9158,0,0,11/01/2023 05:43:00 AM,11/01/2023 07:28:13 AM,11/01/2023 08:15:11 AM
2022/04/01,All Providers,244,117,130,2480,427,2047,0,0,1459305,786380,731041,533042,521194,11205,0,0,11/01/2023 05:43:00 AM,11/01/2023 07:28:13 AM,11/01/2023 08:15:11 AM
2022/04/02,All Providers,131,69,63,1201,184,1014,0,0,1459436,786449,731104,534243,521378,12219,0,0,11/01/2023 05:43:00 AM,11/01/2023 07:28:13 AM,11/01/2023 08:15:11 AM
2022/04/03,All Providers,84,40,44,764,108,654,0,0,1459520,786489,731148,535007,521486,12873,0,0,11/01/2023 05:43:00 AM,11/01/2023 07:28:13 AM,11/01/2023 08:15:11 AM
2022/04/04,All Providers,235,110,129,2741,363,2372,0,0,1459755,786599,731277,537748,521849,15245,0,0,11/01/2023 05:43:00 AM,11/01/2023 07:28:13 AM,11/01/2023 08:15:11 AM
2022/04/05,All Providers,186,99,98,2348,343,1996,0,0,1459941,786698,731375,540096,522192,17241,0,0,11/01/2023 05:43:00 AM,11/01/2023 07:28:13 AM,11/01/2023 08:15:11 AM
2022/04/06,All Providers,204,109,96,2262,341,1912,0,0,1460145,786807,731471,542358,522533,19153,0,0,11/01/2023 05:43:00 AM,11/01/2023 07:28:13 AM,11/01/2023 08:15:11 AM
2022/04/07,All Providers,224,125,104,2508,337,2161,0,0,1460369,786932,731575,544866,522870,21314,0,0,11/01/2023 05:43:00 AM,11/01/2023 07:28:13 AM,11/01/2023 08:15:11 AM
2022/04/08,All Providers,275,121,156,3127,400,2719,0,0,1460644,787053,731731,547993,523270,24033,0,0,11/01/2023 05:43:00 AM,11/01/2023 07:28:13 AM,11/01/2023 08:15:11 AM
2022/04/09,All Providers,139,86,55,1537,199,1335,0,0,1460783,787139,731786,549530,523469,25368,0,0,11/01/2023 05:43:00 AM,11/01/2023 07:28:13 AM,11/01/2023 08:15:11 AM
2022/04/10,All Providers,94,66,28,729,109,616,0,0,1460877,787205,731814,550259,523578,25984,0,0,11/01/2023 05:43:00 AM,11/01/2023 07:28:13 AM,11/01/2023 08:15:11 AM
2022/04/11,All Providers,197,108,92,2613,275,2337,0,0,1461074,787313,731906,552872,523853,28321,0,0,11/01/2023 05:43:00 AM,11/01/2023 07:28:13 AM,11/01/2023 08:15:11 AM
2022/04/12,All Providers,217,129,92,2469,310,2153,0,0,1461291,787442,731998,555341,524163,30474,0,0,11/01/2023 05:43:00 AM,11/01/2023 07:28:13 AM,11/01/2023 08:15:11 AM
2022/04/13,All Providers,248,156,94,2452,317,2126,0,0,1461539,787598,732092,557793,524480,32600,0,0,11/01/2023 05:43:00 AM,11/01/2023 07:28:13 AM,11/01/2023 08:15:11 AM
2022/04/14,All Providers,214,123,93,2558,373,2180,0,0,1461753,787721,732185,560351,524853,34780,0,0,11/01/2023 05:43:00 AM,11/01/2023 07:28:13 AM,11/01/2023 08:15:11 AM
2022/04/15,All Providers,286,156,132,2925,365,2555,0,0,1462039,787877,732317,563276,525218,37335,0,0,11/01/2023 05:43:00 AM,11/01/2023 07:28:13 AM,11/01/2023 08:15:11 AM
2022/04/16,All Providers,171,109,65,1041,159,870,0,0,1462210,787986,732382,564317,525377,38205,0,0,11/01/2023 05:43:00 AM,11/01/2023 07:28:13 AM,11/01/2023 08:15:11 AM
2022/04/17,All Providers,88,74,14,384,69,315,0,0,1462298,788060,732396,564701,525446,38520,0,0,11/01/2023 05:43:00 AM,11/01/2023 07:28:13 AM,11/01/2023 08:15:11 AM
2022/04/18,All Providers,220,127,95,2570,294,2269,0,0,1462518,788187,732491,567271,525740,40789,0,0,11/01/2023 05:43:00 AM,11/01/2023 07:28:13 AM,11/01/2023 08:15:11 AM
2022/04/19,All Providers,200,119,85,2607,302,2296,0,0,1462718,788306,732576,569878,526042,43085,0,0,11/01/2023 05:43:00 AM,11/01/2023 07:28:13 AM,11/01/2023 08:15:11 AM
2022/04/20,All Providers,208,113,97,2356,328,2023,0,0,1462926,788419,732673,572234,526370,45108,0,0,11/01/2023 05:43:00 AM,11/01/2023 07:28:13 AM,11/01/2023 08:15:11 AM
2022/04/21,All Providers,210,132,79,2312,324,1976,0,0,1463136,788551,732752,574546,526694,47084,0,0,11/01/2023 05:43:00 AM,11/01/2023 07:28:13 AM,11/01/2023 08:15:11 AM
2022/04/22,All Providers,216,117,103,2571,320,2241,0,0,1463352,788668,732855,577117,527014,49325,0,0,11/01/2023 05:43:00 AM,11/01/2023 07:28:13 AM,11/01/2023 08:15:11 AM
2022/04/23,All Providers,124,76,48,946,164,777,0,0,1463476,788744,732903,578063,527178,50102,0,0,11/01/2023 05:43:00 AM,11/01/2023 07:28:13 AM,11/01/2023 08:15:11 AM
2022/04/24,All Providers,65,40,25,510,76,432,0,0,1463541,788784,732928,578573,527254,50534,0,0,11/01/2023 05:43:00 AM,11/01/2023 07:28:13 AM,11/01/2023 08:15:11 AM
2022/04/25,All Providers,178,88,92,2202,298,1892,0,0,1463719,788872,733020,580775,527552,52426,0,0,11/01/2023 05:43:00 AM,11/01/2023 07:28:13 AM,11/01/2023 08:15:11 AM
2022/04/26,All Providers,205,97,111,2123,283,1834,0,0,1463924,788969,733131,582898,527835,54260,0,0,11/01/2023 05:43:00 AM,11/01/2023 07:28:13 AM,11/01/2023 08:15:11 AM
2022/04/27,All Providers,197,108,92,2077,297,1769,0,0,1464121,789077,733223,584975,528132,56029,0,0,11/01/2023 05:43:00 AM,11/01/2023 07:28:13 AM,11/01/2023 08:15:11 AM
2022/04/28,All Providers,185,109,76,2201,311,1883,0,0,1464306,789186,733299,587176,528443,57912,0,0,11/01/2023 05:43:00 AM,11/01/2023 07:28:13 AM,11/01/2023 08:15:11 AM
2022/04/29,All Providers,205,115,94,2592,329,2255,0,0,1464511,789301,733393,589768,528772,60167,0,0,11/01/2023 05:43:00 AM,11/01/2023 07:28:13 AM,11/01/2023 08:15:11 AM
2022/04/30,All Providers,105,51,56,927,188,737,0,0,1464616,789352,733449,590695,528960,60904,0,0,11/01/2023 05:43:00 AM,11/01/2023 07:28:13 AM,11/01/2023 08:15:11 AM
2022/05/01,All Providers,71,43,28,492,85,401,0,0,1464687,789395,733477,591187,529045,61305,0,0,11/01/2023 05:43:00 AM,11/01/2023 07:28:13 AM,11/01/2023 08:15:11 AM
2022/05/02,All Providers,204,123,83,2215,274,1934,0,0,1464891,789518,733560,593402,529319,63239,0,0,11/01/2023 05:43:00 AM,11/01/2023 07:28:13 AM,11/01/2023 08:15:11 AM
2022/05/03,All Providers,147,86,62,1841,252,1576,0,0,1465038,789604,733622,595243,529571,64815,0,0,11/01/2023 05:43:00 AM,11/01/2023 07:28:13 AM,11/01/2023 08:15:11 AM
2022/05/04,All Providers,187,87,103,2141,294,1835,0,0,1465225,789691,733725,597384,529865,66650,0,0,11/01/2023 05:43:00 AM,11/01/2023 07:28:13 AM,11/01/2023 08:15:11 AM
2022/05/05,All Providers,180,107,75,1914,242,1663,0,0,1465405,789798,733800,599298,530107,68313,0,0,11/01/2023 05:43:00 AM,11/01/2023 07:28:13 AM,11/01/2023 08:15:11 AM
2022/05/06,All Providers,190,97,95,2321,311,1998,0,0,1465595,789895,733895,601619,530418,70311,0,0,11/01/2023 05:43:00 AM,11/01/2023 07:28:13 AM,11/01/2023 08:15:11 AM
2022/05/07,All Providers,113,63,51,872,138,728,0,0,1465708,789958,733946,602491,530556,71039,0,0,11/01/2023 05:43:00 AM,11/01/2023 07:28:13 AM,11/01/2023 08:15:11 AM
2022/05/08,All Providers,66,43,23,405,75,330,0,0,1465774,790001,733969,602896,530631,71369,0,0,11/01/2023 05:43:00 AM,11/01/2023 07:28:13 AM,11/01/2023 08:15:11 AM
2022/05/09,All Providers,178,92,89,1986,279,1699,0,0,1465952,790093,734058,604882,530910,73068,0,0,11/01/2023 05:43:00 AM,11/01/2023 07:28:13 AM,11/01/2023 08:15:11 AM
2022/05/10,All Providers,165,87,78,1773,249,1519,0,0,1466117,790180,734136,606655,531159,74587,0,0,11/01/2023 05:43:00 AM,11/01/2023 07:28:13 AM,11/01/2023 08:15:11 AM
2022/05/11,All Providers,219,123,99,2008,278,1723,0,0,1466336,790303,734235,608663,531437,76310,0,0,11/01/2023 05:43:00 AM,11/01/2023 07:28:13 AM,11/01/2023 08:15:11 AM
2022/05/12,All Providers,169,93,79,2059,287,1761,0,0,1466505,790396,734314,610722,531724,78071,0,0,11/01/2023 05:43:00 AM,11/01/2023 07:28:13 AM,11/01/2023 08:15:11 AM
2022/05/13,All Providers,223,124,100,2465,338,2117,0,0,1466728,790520,734414,613187,532062,80188,0,0,11/01/2023 05:43:00 AM,11/01/2023 07:28:13 AM,11/01/2023 08:15:11 AM
2022/05/14,All Providers,126,73,53,993,176,811,0,0,1466854,790593,734467,614180,532238,80999,0,0,11/01/2023 05:43:00 AM,11/01/2023 07:28:13 AM,11/01/2023 08:15:11 AM
2022/05/15,All Providers,64,38,26,499,88,409,0,0,1466918,790631,734493,614679,532326,81408,0,0,11/01/2023 05:43:00 AM,11/01/2023 07:28:13 AM,11/01/2023 08:15:11 AM
2022/05/16,All Providers,193,106,89,1986,286,1686,0,0,1467111,790737,734582,616665,532612,83094,0,0,11/01/2023 05:43:00 AM,11/01/2023 07:28:13 AM,11/01/2023 08:15:11 AM
2022/05/17,All Providers,182,107,79,1856,285,1563,0,0,1467293,790844,734661,618521,532897,84657,0,0,11/01/2023 05:43:00 AM,11/01/2023 07:28:13 AM,11/01/2023 08:15:11 AM
2022/05/18,All Providers,180,106,76,1821,321,1491,0,0,1467473,790950,734737,620342,533218,86148,0,0,11/01/2023 05:43:00 AM,11/01/2023 07:28:13 AM,11/01/2023 08:15:11 AM
2022/05/19,All Providers,172,100,73,1837,298,1522,0,0,1467645,791050,734810,622179,533516,87670,0,0,11/01/2023 05:43:00 AM,11/01/2023 07:28:13 AM,11/01/2023 08:15:11 AM
2022/05/20,All Providers,242,145,97,2624,560,2046,0,0,1467887,791195,734907,624803,534076,89716,0,0,11/01/2023 05:43:00 AM,11/01/2023 07:28:13 AM,11/01/2023 08:15:11 AM
2022/05/21,All Providers,138,89,50,1253,423,823,0,0,1468025,791284,734957,626056,534499,90539,0,0,11/01/2023 05:43:00 AM,11/01/2023 07:28:13 AM,11/01/2023 08:15:11 AM
2022/05/22,All Providers,78,33,46,746,299,441,0,0,1468103,791317,735003,626802,534798,90980,0,0,11/01/2023 05:43:00 AM,11/01/2023 07:28:13 AM,11/01/2023 08:15:11 AM
2022/05/23,All Providers,208,114,98,2355,589,1749,0,0,1468311,791431,735101,629157,535387,92729,0,0,11/01/2023 05:43:00 AM,11/01/2023 07:28:13 AM,11/01/2023 08:15:11 AM
2022/05/24,All Providers,169,89,82,2052,572,1464,0,0,1468480,791520,735183,631209,535959,94193,0,0,11/01/2023 05:43:00 AM,11/01/2023 07:28:13 AM,11/01/2023 08:15:11 AM
2022/05/25,All Providers,218,110,111,2174,647,1519,0,0,1468698,791630,735294,633383,536606,95712,0,0,11/01/2023 05:43:00 AM,11/01/2023 07:28:13 AM,11/01/2023 08:15:11 AM
2022/05/26,All Providers,186,112,76,2004,633,1354,0,0,1468884,791742,735370,635387,537239,97066,0,0,11/01/2023 05:43:00 AM,11/01/2023 07:28:13 AM,11/01/2023 08:15:11 AM
2022/05/27,All Providers,201,108,94,2621,833,1770,0,0,1469085,791850,735464,638008,538072,98836,0,0,11/01/2023 05:43:00 AM,11/01/2023 07:28:13 AM,11/01/2023 08:15:11 AM
2022/05/28,All Providers,112,65,48,1138,502,626,0,0,1469197,791915,735512,639146,538574,99462,0,0,11/01/2023 05:43:00 AM,11/01/2023 07:28:13 AM,11/01/2023 08:15:11 AM
2022/05/29,All Providers,64,44,20,594,232,360,0,0,1469261,791959,735532,639740,538806,99822,0,0,11/01/2023 05:43:00 AM,11/01/2023 07:28:13 AM,11/01/2023 08:15:11 AM
2022/05/30,All Providers,16,10,6,166,91,74,0,0,1469277,791969,735538,639906,538897,99896,0,0,11/01/2023 05:43:00 AM,11/01/2023 07:28:13 AM,11/01/2023 08:15:11 AM
2022/05/31,All Providers,213,116,100,2076,537,1521,0,0,1469490,792085,735638,641982,539434,101417,0,0,11/01/2023 05:43:00 AM,11/01/2023 07:28:13 AM,11/01/2023 08:15:11 AM
2022/06/01,All Providers,187,107,80,2219,752,1448,0,0,1469677,792192,735718,644201,540186,102865,0,0,11/01/2023 05:43:00 AM,11/01/2023 07:28:13 AM,11/01/2023 08:15:11 AM
2022/06/02,All Providers,176,100,78,2097,820,1265,0,0,1469853,792292,735796,646298,541006,104130,0,0,11/01/2023 05:43:00 AM,11/01/2023 07:28:13 AM,11/01/2023 08:15:11 AM
2022/06/03,All Providers,233,119,117,2626,894,1711,0,0,1470086,792411,735913,648924,541900,105841,0,0,11/01/2023 05:43:00 AM,11/01/2023 07:28:13 AM,11/01/2023 08:15:11 AM
2022/06/04,All Providers,135,79,57,1016,421,584,0,0,1470221,792490,735970,649940,542321,106425,0,0,11/01/2023 05:43:00 AM,11/01/2023 07:28:13 AM,11/01/2023 08:15:11 AM
2022/06/05,All Providers,62,38,24,468,174,292,0,0,1470283,792528,735994,650408,542495,106717,0,0,11/01/2023 05:43:00 AM,11/01/2023 07:28:13 AM,11/01/2023 08:15:11 AM
2022/06/06,All Providers,188,94,96,1641,544,1085,0,0,1470471,792622,736090,652049,543039,107802,0,0,11/01/2023 05:43:00 AM,11/01/2023 07:28:13 AM,11/01/2023 08:15:11 AM
2022/06/07,All Providers,161,95,68,1448,426,1011,0,0,1470632,792717,736158,653497,543465,108813,0,0,11/01/2023 05:43:00 AM,11/01/2023 07:28:13 AM,11/01/2023 08:15:11 AM
2022/06/08,All Providers,150,92,61,1457,422,1026,0,0,1470782,792809,736219,654954,543887,109839,0,0,11/01/2023 05:43:00 AM,11/01/2023 07:28:13 AM,11/01/2023 08:15:11 AM
2022/06/09,All Providers,173,102,73,1488,439,1037,0,0,1470955,792911,736292,656442,544326,110876,0,0,11/01/2023 05:43:00 AM,11/01/2023 07:28:13 AM,11/01/2023 08:15:11 AM
2022/06/10,All Providers,237,136,104,1806,551,1235,0,0,1471192,793047,736396,658248,544877,112111,0,0,11/01/2023 05:43:00 AM,11/01/2023 07:28:13 AM,11/01/2023 08:15:11 AM
2022/06/11,All Providers,111,59,52,678,313,362,0,0,1471303,793106,736448,658926,545190,112473,0,0,11/01/2023 05:43:00 AM,11/01/2023 07:28:13 AM,11/01/2023 08:15:11 AM
2022/06/12,All Providers,45,27,18,334,112,218,0,0,1471348,793133,736466,659260,545302,112691,0,0,11/01/2023 05:43:00 AM,11/01/2023 07:28:13 AM,11/01/2023 08:15:11 AM
2022/06/13,All Providers,162,85,80,1186,376,797,0,0,1471510,793218,736546,660446,545678,113488,0,0,11/01/2023 05:43:00 AM,11/01/2023 07:28:13 AM,11/01/2023 08:15:11 AM
2022/06/14,All Providers,125,74,52,1148,318,823,0,0,1471635,793292,736598,661594,545996,114311,0,0,11/01/2023 05:43:00 AM,11/01/2023 07:28:13 AM,11/01/2023 08:15:11 AM
2022/06/15,All Providers,158,100,59,1237,343,881,0,0,1471793,793392,736657,662831,546339,115192,0,0,11/01/2023 05:43:00 AM,11/01/2023 07:28:13 AM,11/01/2023 08:15:11 AM
2022/06/16,All Providers,159,97,65,1261,417,833,0,0,1471952,793489,736722,664092,546756,116025,0,0,11/01/2023 05:43:00 AM,11/01/2023 07:28:13 AM,11/01/2023 08:15:11 AM
2022/06/17,All Providers,208,112,96,1528,481,1030,0,0,1472160,793601,736818,665620,547237,117055,0,0,11/01/2023 05:43:00 AM,11/01/2023 07:28:13 AM,11/01/2023 08:15:11 AM
2022/06/18,All Providers,69,44,25,575,215,355,0,0,1472229,793645,736843,666195,547452,117410,0,0,11/01/2023 05:43:00 AM,11/01/2023 07:28:13 AM,11/01/2023 08:15:11 AM
2022/06/19,All Providers,48,29,20,280,114,163,0,0,1472277,793674,736863,666475,547566,117573,0,0,11/01/2023 05:43:00 AM,11/01/2023 07:28:13 AM,11/01/2023 08:15:11 AM
2022/06/20,All Providers,113,77,36,866,236,618,0,0,1472390,793751,736899,667341,547802,118191,0,0,11/01/2023 05:43:00 AM,11/01/2023 07:28:13 AM,11/01/2023 08:15:11 AM
2022/06/21,All Providers,197,142,55,953,264,677,0,0,1472587,793893,736954,668294,548066,118868,0,0,11/01/2023 05:43:00 AM,11/01/2023 07:28:13 AM,11/01/2023 08:15:11 AM
2022/06/22,All Providers,370,313,58,1074,306,751,0,0,1472957,794206,737012,669368,548372,119619,0,0,11/01/2023 05:43:00 AM,11/01/2023 07:28:13 AM,11/01/2023 08:15:11 AM
2022/06/23,All Providers,535,464,72,1115,337,769,0,0,1473492,794670,737084,670483,548709,120388,0,0,11/01/2023 05:43:00 AM,11/01/2023 07:28:13 AM,11/01/2023 08:15:11 AM
2022/06/24,All Providers,881,796,87,1398,486,898,0,0,1474373,795466,737171,671881,549195,121286,0,0,11/01/2023 05:43:00 AM,11/01/2023 07:28:13 AM,11/01/2023 08:15:11 AM
2022/06/25,All Providers,707,674,33,457,196,256,0,0,1475080,796140,737204,672338,549391,121542,0,0,11/01/2023 05:43:00 AM,11/01/2023 07:28:13 AM,11/01/2023 08:15:11 AM
2022/06/26,All Providers,127,112,15,220,66,152,0,0,1475207,796252,737219,672558,549457,121694,0,0,11/01/2023 05:43:00 AM,11/01/2023 07:28:13 AM,11/01/2023 08:15:11 AM
2022/06/27,All Providers,600,542,59,966,283,674,0,0,1475807,796794,737278,673524,549740,122368,0,0,11/01/2023 05:43:00 AM,11/01/2023 07:28:13 AM,11/01/2023 08:15:11 AM
2022/06/28,All Providers,583,521,62,922,266,639,0,0,1476390,797315,737340,674446,550006,123007,0,0,11/01/2023 05:43:00 AM,11/01/2023 07:28:13 AM,11/01/2023 08:15:11 AM
2022/06/29,All Providers,545,481,67,1036,268,758,0,0,1476935,797796,737407,675482,550274,123765,0,0,11/01/2023 05:43:00 AM,11/01/2023 07:28:13 AM,11/01/2023 08:15:11 AM
2022/06/30,All Providers,525,472,53,1063,398,657,0,0,1477460,798268,737460,676545,550672,124422,0,0,11/01/2023 05:43:00 AM,11/01/2023 07:28:13 AM,11/01/2023 08:15:11 AM
2022/07/01,All Providers,615,557,59,1100,309,775,0,0,1478075,798825,737519,677645,550981,125197,0,0,11/01/2023 05:43:00 AM,11/01/2023 07:28:13 AM,11/01/2023 08:15:11 AM
2022/07/02,All Providers,232,204,28,389,146,234,0,0,1478307,799029,737547,678034,551127,125431,0,0,11/01/2023 05:43:00 AM,11/01/2023 07:28:13 AM,11/01/2023 08:15:11 AM
2022/07/03,All Providers,55,45,11,219,60,157,0,0,1478362,799074,737558,678253,551187,125588,0,0,11/01/2023 05:43:00 AM,11/01/2023 07:28:13 AM,11/01/2023 08:15:11 AM
2022/07/04,All Providers,77,74,4,52,34,18,0,0,1478439,799148,737562,678305,551221,125606,0,0,11/01/2023 05:43:00 AM,11/01/2023 07:28:13 AM,11/01/2023 08:15:11 AM
2022/07/05,All Providers,453,385,70,915,263,639,0,0,1478892,799533,737632,679220,551484,126245,0,0,11/01/2023 05:43:00 AM,11/01/2023 07:28:13 AM,11/01/2023 08:15:11 AM
2022/07/06,All Providers,384,324,61,1038,308,724,0,0,1479276,799857,737693,680258,551792,126969,0,0,11/01/2023 05:43:00 AM,11/01/2023 07:28:13 AM,11/01/2023 08:15:11 AM
2022/07/07,All Providers,414,355,62,974,271,695,0,0,1479690,800212,737755,681232,552063,127664,0,0,11/01/2023 05:43:00 AM,11/01/2023 07:28:13 AM,11/01/2023 08:15:11 AM
2022/07/08,All Providers,592,517,78,1189,315,851,0,0,1480282,800729,737833,682421,552378,128515,0,0,11/01/2023 05:43:00 AM,11/01/2023 07:28:13 AM,11/01/2023 08:15:11 AM
2022/07/09,All Providers,148,131,18,445,110,325,0,0,1480430,800860,737851,682866,552488,128840,0,0,11/01/2023 05:43:00 AM,11/01/2023 07:28:13 AM,11/01/2023 08:15:11 AM
2022/07/10,All Providers,57,40,17,272,64,201,0,0,1480487,800900,737868,683138,552552,129041,0,0,11/01/2023 05:43:00 AM,11/01/2023 07:28:13 AM,11/01/2023 08:15:11 AM
2022/07/11,All Providers,329,270,60,1025,285,724,0,0,1480816,801170,737928,684163,552837,129765,0,0,11/01/2023 05:43:00 AM,11/01/2023 07:28:13 AM,11/01/2023 08:15:11 AM
2022/07/12,All Providers,383,325,59,950,280,659,0,0,1481199,801495,737987,685113,553117,130424,0,0,11/01/2023 05:43:00 AM,11/01/2023 07:28:13 AM,11/01/2023 08:15:11 AM
2022/07/13,All Providers,349,271,79,1145,243,878,0,0,1481548,801766,738066,686258,553360,131302,0,0,11/01/2023 05:43:00 AM,11/01/2023 07:28:13 AM,11/01/2023 08:15:11 AM
2022/07/14,All Providers,392,270,124,1129,272,842,0,0,1481940,802036,738190,687387,553632,132144,0,0,11/01/2023 05:43:00 AM,11/01/2023 07:28:13 AM,11/01/2023 08:15:11 AM
2022/07/15,All Providers,668,423,247,1426,332,1074,0,0,1482608,802459,738437,688813,553964,133218,0,0,11/01/2023 05:43:00 AM,11/01/2023 07:28:13 AM,11/01/2023 08:15:11 AM
2022/07/16,All Providers,288,105,183,608,166,433,0,0,1482896,802564,738620,689421,554130,133651,0,0,11/01/2023 05:43:00 AM,11/01/2023 07:28:13 AM,11/01/2023 08:15:11 AM
2022/07/17,All Providers,97,45,52,280,60,209,0,0,1482993,802609,738672,689701,554190,133860,0,0,11/01/2023 05:43:00 AM,11/01/2023 07:28:13 AM,11/01/2023 08:15:11 AM
2022/07/18,All Providers,388,239,151,1046,238,790,0,0,1483381,802848,738823,690747,554428,134650,0,0,11/01/2023 05:43:00 AM,11/01/2023 07:28:13 AM,11/01/2023 08:15:11 AM
2022/07/19,All Providers,415,257,159,1009,259,731,0,0,1483796,803105,738982,691756,554687,135381,0,0,11/01/2023 05:43:00 AM,11/01/2023 07:28:13 AM,11/01/2023 08:15:11 AM
2022/07/20,All Providers,424,223,201,923,252,657,0,0,1484220,803328,739183,692679,554939,136038,0,0,11/01/2023 05:43:00 AM,11/01/2023 07:28:13 AM,11/01/2023 08:15:11 AM
2022/07/21,All Providers,491,223,268,980,275,688,0,0,1484711,803551,739451,693659,555214,136726,0,0,11/01/2023 05:43:00 AM,11/01/2023 07:28:13 AM,11/01/2023 08:15:11 AM
2022/07/22,All Providers,849,329,521,1210,319,875,0,0,1485560,803880,739972,694869,555533,137601,0,0,11/01/2023 05:43:00 AM,11/01/2023 07:28:13 AM,11/01/2023 08:15:11 AM
2022/07/23,All Providers,508,143,366,441,121,308,0,0,1486068,804023,740338,695310,555654,137909,0,0,11/01/2023 05:43:00 AM,11/01/2023 07:28:13 AM,11/01/2023 08:15:11 AM
2022/07/24,All Providers,87,39,48,215,52,160,0,0,1486155,804062,740386,695525,555706,138069,0,0,11/01/2023 05:43:00 AM,11/01/2023 07:28:13 AM,11/01/2023 08:15:11 AM
2022/07/25,All Providers,568,222,346,806,224,564,0,0,1486723,804284,740732,696331,555930,138633,0,0,11/01/2023 05:43:00 AM,11/01/2023 07:28:13 AM,11/01/2023 08:15:11 AM
2022/07/26,All Providers,499,189,311,840,255,570,0,0,1487222,804473,741043,697171,556185,139203,0,0,11/01/2023 05:43:00 AM,11/01/2023 07:28:13 AM,11/01/2023 08:15:11 AM
2022/07/27,All Providers,454,166,290,747,218,517,0,0,1487676,804639,741333,697918,556403,139720,0,0,11/01/2023 05:43:00 AM,11/01/2023 07:28:13 AM,11/01/2023 08:15:11 AM
2022/07/28,All Providers,487,184,303,790,227,550,0,0,1488163,804823,741636,698708,556630,140270,0,0,11/01/2023 05:43:00 AM,11/01/2023 07:28:13 AM,11/01/2023 08:15:11 AM
2022/07/29,All Providers,767,292,477,882,285,568,0,0,1488930,805115,742113,699590,556915,140838,0,0,11/01/2023 05:43:00 AM,11/01/2023 07:28:13 AM,11/01/2023 08:15:11 AM
2022/07/30,All Providers,295,87,208,320,112,203,0,0,1489225,805202,742321,699910,557027,141041,0,0,11/01/2023 05:43:00 AM,11/01/2023 07:28:13 AM,11/01/2023 08:15:11 AM
2022/07/31,All Providers,64,26,38,155,39,112,0,0,1489289,805228,742359,700065,557066,141153,0,0,11/01/2023 05:43:00 AM,11/01/2023 07:28:13 AM,11/01/2023 08:15:11 AM
2022/08/01,All Providers,403,173,231,653,223,416,0,0,1489692,805401,742590,700718,557289,141569,0,0,11/01/2023 05:43:00 AM,11/01/2023 07:28:13 AM,11/01/2023 08:15:11 AM
2022/08/02,All Providers,397,163,234,583,209,364,0,0,1490089,805564,742824,701301,557498,141933,0,0,11/01/2023 05:43:00 AM,11/01/2023 07:28:13 AM,11/01/2023 08:15:11 AM
2022/08/03,All Providers,368,157,212,653,231,405,0,0,1490457,805721,743036,701954,557729,142338,0,0,11/01/2023 05:43:00 AM,11/01/2023 07:28:13 AM,11/01/2023 08:15:11 AM
2022/08/04,All Providers,405,175,230,615,220,378,0,0,1490862,805896,743266,702569,557949,142716,0,0,11/01/2023 05:43:00 AM,11/01/2023 07:28:13 AM,11/01/2023 08:15:11 AM
2022/08/05,All Providers,636,256,380,721,267,440,0,0,1491498,806152,743646,703290,558216,143156,0,0,11/01/2023 05:43:00 AM,11/01/2023 07:28:13 AM,11/01/2023 08:15:11 AM
2022/08/06,All Providers,237,136,102,354,159,183,0,0,1491735,806288,743748,703644,558375,143339,0,0,11/01/2023 05:43:00 AM,11/01/2023 07:28:13 AM,11/01/2023 08:15:11 AM
2022/08/07,All Providers,50,31,19,121,41,79,0,0,1491785,806319,743767,703765,558416,143418,0,0,11/01/2023 05:43:00 AM,11/01/2023 07:28:13 AM,11/01/2023 08:15:11 AM
2022/08/08,All Providers,390,159,231,615,253,342,0,0,1492175,806478,743998,704380,558669,143760,0,0,11/01/2023 05:43:00 AM,11/01/2023 07:28:13 AM,11/01/2023 08:15:11 AM
2022/08/09,All Providers,402,162,241,617,278,327,0,0,1492577,806640,744239,704997,558947,144087,0,0,11/01/2023 05:43:00 AM,11/01/2023 07:28:13 AM,11/01/2023 08:15:11 AM
2022/08/10,All Providers,371,154,219,459,214,237,0,0,1492948,806794,744458,705456,559161,144324,0,0,11/01/2023 05:43:00 AM,11/01/2023 07:28:13 AM,11/01/2023 08:15:11 AM
2022/08/11,All Providers,334,131,203,511,228,272,0,0,1493282,806925,744661,705967,559389,144596,0,0,11/01/2023 05:43:00 AM,11/01/2023 07:28:13 AM,11/01/2023 08:15:11 AM
2022/08/12,All Providers,710,328,382,754,324,409,0,0,1493992,807253,745043,706721,559713,145005,0,0,11/01/2023 05:43:00 AM,11/01/2023 07:28:13 AM,11/01/2023 08:15:11 AM
2022/08/13,All Providers,167,91,77,279,109,163,0,0,1494159,807344,745120,707000,559822,145168,0,0,11/01/2023 05:43:00 AM,11/01/2023 07:28:13 AM,11/01/2023 08:15:11 AM
2022/08/14,All Providers,49,31,19,133,63,64,0,0,1494208,807375,745139,707133,559885,145232,0,0,11/01/2023 05:43:00 AM,11/01/2023 07:28:13 AM,11/01/2023 08:15:11 AM
2022/08/15,All Providers,351,162,189,609,264,328,0,0,1494559,807537,745328,707742,560149,145560,0,0,11/01/2023 05:43:00 AM,11/01/2023 07:28:13 AM,11/01/2023 08:15:11 AM
2022/08/16,All Providers,354,148,208,552,222,310,0,0,1494913,807685,745536,708294,560371,145870,0,0,11/01/2023 05:43:00 AM,11/01/2023 07:28:13 AM,11/01/2023 08:15:11 AM
2022/08/17,All Providers,329,147,183,440,156,272,0,0,1495242,807832,745719,708734,560527,146142,0,0,11/01/2023 05:43:00 AM,11/01/2023 07:28:13 AM,11/01/2023 08:15:11 AM
2022/08/18,All Providers,319,145,174,467,147,312,0,0,1495561,807977,745893,709201,560674,146454,0,0,11/01/2023 05:43:00 AM,11/01/2023 07:28:13 AM,11/01/2023 08:15:11 AM
2022/08/19,All Providers,551,231,323,530,191,313,0,0,1496112,808208,746216,709731,560865,146767,0,0,11/01/2023 05:43:00 AM,11/01/2023 07:28:13 AM,11/01/2023 08:15:11 AM
2022/08/20,All Providers,162,87,75,234,93,136,0,0,1496274,808295,746291,709965,560958,146903,0,0,11/01/2023 05:43:00 AM,11/01/2023 07:28:13 AM,11/01/2023 08:15:11 AM
2022/08/21,All Providers,38,27,11,71,27,40,0,0,1496312,808322,746302,710036,560985,146943,0,0,11/01/2023 05:43:00 AM,11/01/2023 07:28:13 AM,11/01/2023 08:15:11 AM
2022/08/22,All Providers,297,138,159,432,150,267,0,0,1496609,808460,746461,710468,561135,147210,0,0,11/01/2023 05:43:00 AM,11/01/2023 07:28:13 AM,11/01/2023 08:15:11 AM
2022/08/23,All Providers,301,129,175,426,151,266,0,0,1496910,808589,746636,710894,561286,147476,0,0,11/01/2023 05:43:00 AM,11/01/2023 07:28:13 AM,11/01/2023 08:15:11 AM
2022/08/24,All Providers,339,148,193,401,177,217,0,0,1497249,808737,746829,711295,561463,147693,0,0,11/01/2023 05:43:00 AM,11/01/2023 07:28:13 AM,11/01/2023 08:15:11 AM
2022/08/25,All Providers,310,151,164,388,138,240,0,0,1497559,808888,746993,711683,561601,147933,0,0,11/01/2023 05:43:00 AM,11/01/2023 07:28:13 AM,11/01/2023 08:15:11 AM
2022/08/26,All Providers,492,186,309,442,168,264,0,0,1498051,809074,747302,712125,561769,148197,0,0,11/01/2023 05:43:00 AM,11/01/2023 07:28:13 AM,11/01/2023 08:15:11 AM
2022/08/27,All Providers,133,51,82,157,69,85,0,0,1498184,809125,747384,712282,561838,148282,0,0,11/01/2023 05:43:00 AM,11/01/2023 07:28:13 AM,11/01/2023 08:15:11 AM
2022/08/28,All Providers,41,21,20,69,28,37,0,0,1498225,809146,747404,712351,561866,148319,0,0,11/01/2023 05:43:00 AM,11/01/2023 07:28:13 AM,11/01/2023 08:15:11 AM
2022/08/29,All Providers,244,113,131,312,119,186,0,0,1498469,809259,747535,712663,561985,148505,0,0,11/01/2023 05:43:00 AM,11/01/2023 07:28:13 AM,11/01/2023 08:15:11 AM
2022/08/30,All Providers,263,117,146,314,121,179,0,0,1498732,809376,747681,712977,562106,148684,0,0,11/01/2023 05:43:00 AM,11/01/2023 07:28:13 AM,11/01/2023 08:15:11 AM
2022/08/31,All Providers,212,101,112,257,93,152,2,2,1498944,809477,747793,713234,562199,148836,2,2,11/01/2023 05:43:00 AM,11/01/2023 07:28:13 AM,11/01/2023 08:15:11 AM
2022/09/01,All Providers,212,98,117,135,72,60,11,11,1499156,809575,747910,713369,562271,148896,13,13,11/01/2023 05:43:00 AM,11/01/2023 07:28:13 AM,11/01/2023 08:15:11 AM
2022/09/02,All Providers,390,141,249,87,64,20,12,12,1499546,809716,748159,713456,562335,148916,25,25,11/01/2023 05:43:00 AM,11/01/2023 07:28:13 AM,11/01/2023 08:15:11 AM
2022/09/03,All Providers,74,25,53,13,9,2,105,105,1499620,809741,748212,713469,562344,148918,130,130,11/01/2023 05:43:00 AM,11/01/2023 07:28:13 AM,11/01/2023 08:15:11 AM
2022/09/04,All Providers,9,4,8,8,4,4,86,86,1499629,809745,748220,713477,562348,148922,216,216,11/01/2023 05:43:00 AM,11/01/2023 07:28:13 AM,11/01/2023 08:15:11 AM
2022/09/05,All Providers,9,3,7,3,2,0,5,5,1499638,809748,748227,713480,562350,148922,221,221,11/01/2023 05:43:00 AM,11/01/2023 07:28:13 AM,11/01/2023 08:15:11 AM
2022/09/06,All Providers,194,72,137,38,26,9,319,319,1499832,809820,748364,713518,562376,148931,540,540,11/01/2023 05:43:00 AM,11/01/2023 07:28:13 AM,11/01/2023 08:15:11 AM
2022/09/07,All Providers,178,68,163,47,27,10,1926,1926,1500010,809888,748527,713565,562403,148941,2466,2466,11/01/2023 05:43:00 AM,11/01/2023 07:28:13 AM,11/01/2023 08:15:11 AM
2022/09/08,All Providers,166,73,148,38,16,13,2108,2108,1500176,809961,748675,713603,562419,148954,4574,4574,11/01/2023 05:43:00 AM,11/01/2023 07:28:13 AM,11/01/2023 08:15:11 AM
2022/09/09,All Providers,331,111,284,53,37,10,2333,2333,1500507,810072,748959,713656,562456,148964,6907,6907,11/01/2023 05:43:00 AM,11/01/2023 07:28:13 AM,11/01/2023 08:15:11 AM
2022/09/10,All Providers,90,28,107,18,15,2,1286,1286,1500597,810100,749066,713674,562471,148966,8193,8193,11/01/2023 05:43:00 AM,11/01/2023 07:28:13 AM,11/01/2023 08:15:11 AM
2022/09/11,All Providers,14,4,40,9,4,3,900,900,1500611,810104,749106,713683,562475,148969,9093,9093,11/01/2023 05:43:00 AM,11/01/2023 07:28:13 AM,11/01/2023 08:15:11 AM
2022/09/12,All Providers,151,64,184,49,25,16,3510,3510,1500762,810168,749290,713732,562500,148985,12603,12603,11/01/2023 05:43:00 AM,11/01/2023 07:28:13 AM,11/01/2023 08:15:11 AM
2022/09/13,All Providers,150,72,170,68,35,15,3428,3428,1500912,810240,749460,713800,562535,149000,16031,16031,11/01/2023 05:43:00 AM,11/01/2023 07:28:13 AM,11/01/2023 08:15:11 AM
2022/09/14,All Providers,166,69,195,57,30,13,3600,3600,1501078,810309,749655,713857,562565,149013,19631,19631,11/01/2023 05:43:00 AM,11/01/2023 07:28:13 AM,11/01/2023 08:15:11 AM
2022/09/15,All Providers,160,68,176,169,36,98,3915,3915,1501238,810377,749831,714026,562601,149111,23546,23546,11/01/2023 05:43:00 AM,11/01/2023 07:28:13 AM,11/01/2023 08:15:11 AM
2022/09/16,All Providers,326,108,312,94,51,28,4305,4305,1501564,810485,750143,714120,562652,149139,27851,27851,11/01/2023 05:43:00 AM,11/01/2023 07:28:13 AM,11/01/2023 08:15:11 AM
2022/09/17,All Providers,53,22,76,44,17,19,1818,1818,1501617,810507,750219,714164,562669,149158,29669,29669,11/01/2023 05:43:00 AM,11/01/2023 07:28:13 AM,11/01/2023 08:15:11 AM
2022/09/18,All Providers,10,3,35,7,4,3,1002,1002,1501627,810510,750254,714171,562673,149161,30671,30671,11/01/2023 05:43:00 AM,11/01/2023 07:28:13 AM,11/01/2023 08:15:11 AM
2022/09/19,All Providers,158,69,186,61,36,17,3833,3832,1501785,810579,750440,714232,562709,149178,34504,34503,11/01/2023 05:43:00 AM,11/01/2023 07:28:13 AM,11/01/2023 08:15:11 AM
2022/09/20,All Providers,147,61,164,67,39,18,3826,3825,1501932,810640,750604,714299,562748,149196,38330,38328,11/01/2023 05:43:00 AM,11/01/2023 07:28:13 AM,11/01/2023 08:15:11 AM
2022/09/21,All Providers,127,56,178,93,40,34,3846,3846,1502059,810696,750782,714392,562788,149230,42176,42174,11/01/2023 05:43:00 AM,11/01/2023 07:28:13 AM,11/01/2023 08:15:11 AM
2022/09/22,All Providers,172,67,205,94,40,26,3853,3853,1502231,810763,750987,714486,562828,149256,46029,46027,11/01/2023 05:43:00 AM,11/01/2023 07:28:13 AM,11/01/2023 08:15:11 AM
2022/09/23,All Providers,276,111,276,90,54,22,4335,4334,1502507,810874,751263,714576,562882,149278,50364,50361,11/01/2023 05:43:00 AM,11/01/2023 07:28:13 AM,11/01/2023 08:15:11 AM
2022/09/24,All Providers,40,15,78,52,8,31,2113,2113,1502547,810889,751341,714628,562890,149309,52477,52474,11/01/2023 05:43:00 AM,11/01/2023 07:28:13 AM,11/01/2023 08:15:11 AM
2022/09/25,All Providers,10,5,28,6,4,1,945,944,1502557,810894,751369,714634,562894,149310,53422,53418,11/01/2023 05:43:00 AM,11/01/2023 07:28:13 AM,11/01/2023 08:15:11 AM
2022/09/26,All Providers,118,64,166,72,32,30,4088,4086,1502675,810958,751535,714706,562926,149340,57510,57504,11/01/2023 05:43:00 AM,11/01/2023 07:28:13 AM,11/01/2023 08:15:11 AM
2022/09/27,All Providers,136,69,192,62,29,22,3837,3837,1502811,811027,751727,714768,562955,149362,61347,61341,11/01/2023 05:43:00 AM,11/01/2023 07:28:13 AM,11/01/2023 08:15:11 AM
2022/09/28,All Providers,134,63,181,69,33,24,3992,3989,1502945,811090,751908,714837,562988,149386,65339,65330,11/01/2023 05:43:00 AM,11/01/2023 07:28:13 AM,11/01/2023 08:15:11 AM
2022/09/29,All Providers,98,56,138,59,28,20,3793,3792,1503043,811146,752046,714896,563016,149406,69132,69122,11/01/2023 05:43:00 AM,11/01/2023 07:28:13 AM,11/01/2023 08:15:11 AM
2022/09/30,All Providers,204,87,243,67,27,30,4033,4032,1503247,811233,752289,714963,563043,149436,73165,73154,11/01/2023 05:43:00 AM,11/01/2023 07:28:13 AM,11/01/2023 08:15:11 AM
2022/10/01,All Providers,46,19,60,106,15,63,1870,1869,1503293,811252,752349,715069,563058,149499,75035,75023,11/01/2023 05:43:00 AM,11/01/2023 07:28:13 AM,11/01/2023 08:15:11 AM
2022/10/02,All Providers,14,6,45,65,11,41,1010,1009,1503307,811258,752394,715134,563069,149540,76045,76032,11/01/2023 05:43:00 AM,11/01/2023 07:28:13 AM,11/01/2023 08:15:11 AM
2022/10/03,All Providers,122,65,168,56,18,22,3947,3946,1503429,811323,752562,715190,563087,149562,79992,79978,11/01/2023 05:43:00 AM,11/01/2023 07:28:13 AM,11/01/2023 08:15:11 AM
2022/10/04,All Providers,105,59,117,51,26,19,3710,3709,1503534,811382,752679,715241,563113,149581,83702,83687,11/01/2023 05:43:00 AM,11/01/2023 07:28:13 AM,11/01/2023 08:15:11 AM
2022/10/05,All Providers,87,44,144,60,25,19,4011,4007,1503621,811426,752823,715301,563138,149600,87713,87694,11/01/2023 05:43:00 AM,11/01/2023 07:28:13 AM,11/01/2023 08:15:11 AM
2022/10/06,All Providers,93,43,156,53,18,21,3883,3881,1503714,811469,752979,715354,563156,149621,91596,91575,11/01/2023 05:43:00 AM,11/01/2023 07:28:13 AM,11/01/2023 08:15:11 AM
2022/10/07,All Providers,152,66,183,76,27,30,4122,4121,1503866,811535,753162,715430,563183,149651,95718,95696,11/01/2023 05:43:00 AM,11/01/2023 07:28:13 AM,11/01/2023 08:15:11 AM
2022/10/08,All Providers,44,26,71,34,11,15,2263,2263,1503910,811561,753233,715464,563194,149666,97981,97959,11/01/2023 05:43:00 AM,11/01/2023 07:28:13 AM,11/01/2023 08:15:11 AM
2022/10/09,All Providers,3,0,41,1,1,0,833,832,1503913,811561,753274,715465,563195,149666,98814,98791,11/01/2023 05:43:00 AM,11/01/2023 07:28:13 AM,11/01/2023 08:15:11 AM
2022/10/10,All Providers,78,38,169,53,15,29,3806,3806,1503991,811599,753443,715518,563210,149695,102620,102597,11/01/2023 05:43:00 AM,11/01/2023 07:28:13 AM,11/01/2023 08:15:11 AM
2022/10/11,All Providers,75,44,135,63,14,27,4344,4344,1504066,811643,753578,715581,563224,149722,106964,106941,11/01/2023 05:43:00 AM,11/01/2023 07:28:13 AM,11/01/2023 08:15:11 AM
2022/10/12,All Providers,97,48,174,63,17,15,4417,4415,1504163,811691,753752,715644,563241,149737,111381,111356,11/01/2023 05:43:00 AM,11/01/2023 07:28:13 AM,11/01/2023 08:15:11 AM
2022/10/13,All Providers,85,39,126,43,16,17,4217,4215,1504248,811730,753878,715687,563257,149754,115598,115571,11/01/2023 05:43:00 AM,11/01/2023 07:28:13 AM,11/01/2023 08:15:11 AM
2022/10/14,All Providers,155,78,183,48,13,17,4507,4501,1504403,811808,754061,715735,563270,149771,120105,120072,11/01/2023 05:43:00 AM,11/01/2023 07:28:13 AM,11/01/2023 08:15:11 AM
2022/10/15,All Providers,28,16,61,31,7,18,2060,2056,1504431,811824,754122,715766,563277,149789,122165,122128,11/01/2023 05:43:00 AM,11/01/2023 07:28:13 AM,11/01/2023 08:15:11 AM
2022/10/16,All Providers,8,2,39,2,0,0,872,870,1504439,811826,754161,715768,563277,149789,123037,122998,11/01/2023 05:43:00 AM,11/01/2023 07:28:13 AM,11/01/2023 08:15:11 AM
2022/10/17,All Providers,63,38,145,36,10,15,4280,4278,1504502,811864,754306,715804,563287,149804,127317,127276,11/01/2023 05:43:00 AM,11/01/2023 07:28:13 AM,11/01/2023 08:15:11 AM
2022/10/18,All Providers,88,46,156,32,4,19,4114,4112,1504590,811910,754462,715836,563291,149823,131431,131388,11/01/2023 05:43:00 AM,11/01/2023 07:28:13 AM,11/01/2023 08:15:11 AM
2022/10/19,All Providers,77,43,153,34,9,13,4194,4193,1504667,811953,754615,715870,563300,149836,135625,135581,11/01/2023 05:43:00 AM,11/01/2023 07:28:13 AM,11/01/2023 08:15:11 AM
2022/10/20,All Providers,97,38,158,31,12,15,4266,4260,1504764,811991,754773,715901,563312,149851,139891,139841,11/01/2023 05:43:00 AM,11/01/2023 07:28:13 AM,11/01/2023 08:15:11 AM
2022/10/21,All Providers,171,86,213,135,12,91,4544,4537,1504935,812077,754986,716036,563324,149942,144435,144378,11/01/2023 05:43:00 AM,11/01/2023 07:28:13 AM,11/01/2023 08:15:11 AM
2022/10/22,All Providers,32,17,77,38,8,26,2280,2276,1504967,812094,755063,716074,563332,149968,146715,146654,11/01/2023 05:43:00 AM,11/01/2023 07:28:13 AM,11/01/2023 08:15:11 AM
2022/10/23,All Providers,6,3,31,14,3,3,718,718,1504973,812097,755094,716088,563335,149971,147433,147372,11/01/2023 05:43:00 AM,11/01/2023 07:28:13 AM,11/01/2023 08:15:11 AM
2022/10/24,All Providers,106,51,160,37,6,15,3876,3874,1505079,812148,755254,716125,563341,149986,151309,151246,11/01/2023 05:43:00 AM,11/01/2023 07:28:13 AM,11/01/2023 08:15:11 AM
2022/10/25,All Providers,91,51,139,30,4,14,3897,3892,1505170,812199,755393,716155,563345,150000,155206,155138,11/01/2023 05:43:00 AM,11/01/2023 07:28:13 AM,11/01/2023 08:15:11 AM
2022/10/26,All Providers,89,60,166,30,4,17,4307,4302,1505259,812259,755559,716185,563349,150017,159513,159440,11/01/2023 05:43:00 AM,11/01/2023 07:28:13 AM,11/01/2023 08:15:11 AM
2022/10/27,All Providers,111,67,152,38,13,14,4141,4135,1505370,812326,755711,716223,563362,150031,163654,163575,11/01/2023 05:43:00 AM,11/01/2023 07:28:13 AM,11/01/2023 08:15:11 AM
2022/10/28,All Providers,165,81,203,60,9,22,4380,4376,1505535,812407,755914,716283,563371,150053,168034,167951,11/01/2023 05:43:00 AM,11/01/2023 07:28:13 AM,11/01/2023 08:15:11 AM
2022/10/29,All Providers,38,18,69,21,1,13,2118,2114,1505573,812425,755983,716304,563372,150066,170152,170065,11/01/2023 05:43:00 AM,11/01/2023 07:28:13 AM,11/01/2023 08:15:11 AM
2022/10/30,All Providers,4,2,33,1,0,0,805,805,1505577,812427,756016,716305,563372,150066,170957,170870,11/01/2023 05:43:00 AM,11/01/2023 07:28:13 AM,11/01/2023 08:15:11 AM
2022/10/31,All Providers,54,24,124,16,1,10,3561,3555,1505631,812451,756140,716321,563373,150076,174518,174425,11/01/2023 05:43:00 AM,11/01/2023 07:28:13 AM,11/01/2023 08:15:11 AM
2022/11/01,All Providers,83,40,134,27,5,12,3321,3317,1505714,812491,756274,716348,563378,150088,177839,177742,11/01/2023 05:43:00 AM,11/01/2023 07:28:13 AM,11/01/2023 08:15:11 AM
2022/11/02,All Providers,95,55,152,34,5,20,3803,3801,1505809,812546,756426,716382,563383,150108,181642,181543,11/01/2023 05:43:00 AM,11/01/2023 07:28:13 AM,11/01/2023 08:15:11 AM
2022/11/03,All Providers,101,53,141,17,2,10,3513,3510,1505910,812599,756567,716399,563385,150118,185155,185053,11/01/2023 05:43:00 AM,11/01/2023 07:28:13 AM,11/01/2023 08:15:11 AM
2022/11/04,All Providers,156,76,179,55,12,26,4279,4276,1506066,812675,756746,716454,563397,150144,189434,189329,11/01/2023 05:43:00 AM,11/01/2023 07:28:13 AM,11/01/2023 08:15:11 AM
2022/11/05,All Providers,47,24,64,29,2,18,1576,1575,1506113,812699,756810,716483,563399,150162,191010,190904,11/01/2023 05:43:00 AM,11/01/2023 07:28:13 AM,11/01/2023 08:15:11 AM
2022/11/06,All Providers,7,6,23,1,0,1,761,760,1506120,812705,756833,716484,563399,150163,191771,191664,11/01/2023 05:43:00 AM,11/01/2023 07:28:13 AM,11/01/2023 08:15:11 AM
2022/11/07,All Providers,83,49,141,34,5,18,3534,3525,1506203,812754,756974,716518,563404,150181,195305,195189,11/01/2023 05:43:00 AM,11/01/2023 07:28:13 AM,11/01/2023 08:15:11 AM
2022/11/08,All Providers,79,50,125,19,3,11,3209,3206,1506282,812804,757099,716537,563407,150192,198514,198395,11/01/2023 05:43:00 AM,11/01/2023 07:28:13 AM,11/01/2023 08:15:11 AM
2022/11/09,All Providers,76,40,138,26,2,18,3369,3365,1506358,812844,757237,716563,563409,150210,201883,201760,11/01/2023 05:43:00 AM,11/01/2023 07:28:13 AM,11/01/2023 08:15:11 AM
2022/11/10,All Providers,89,43,155,27,8,15,3649,3644,1506447,812887,757392,716590,563417,150225,205532,205404,11/01/2023 05:43:00 AM,11/01/2023 07:28:13 AM,11/01/2023 08:15:11 AM
2022/11/11,All Providers,137,72,187,29,3,16,3880,3876,1506584,812959,757579,716619,563420,150241,209412,209280,11/01/2023 05:43:00 AM,11/01/2023 07:28:13 AM,11/01/2023 08:15:11 AM
2022/11/12,All Providers,37,22,60,26,2,17,1393,1391,1506621,812981,757639,716645,563422,150258,210805,210671,11/01/2023 05:43:00 AM,11/01/2023 07:28:13 AM,11/01/2023 08:15:11 AM
2022/11/13,All Providers,5,3,34,1,0,1,762,760,1506626,812984,757673,716646,563422,150259,211567,211431,11/01/2023 05:43:00 AM,11/01/2023 07:28:13 AM,11/01/2023 08:15:11 AM
2022/11/14,All Providers,84,37,157,41,13,16,3226,3224,1506710,813021,757830,716687,563435,150275,214793,214655,11/01/2023 05:43:00 AM,11/01/2023 07:28:13 AM,11/01/2023 08:15:11 AM
2022/11/15,All Providers,101,52,155,24,8,12,3086,3076,1506811,813073,757985,716711,563443,150287,217879,217731,11/01/2023 05:43:00 AM,11/01/2023 07:28:13 AM,11/01/2023 08:15:11 AM
2022/11/16,All Providers,93,50,150,30,4,18,3310,3305,1506904,813123,758135,716741,563447,150305,221189,221036,11/01/2023 05:43:00 AM,11/01/2023 07:28:13 AM,11/01/2023 08:15:11 AM
2022/11/17,All Providers,123,71,156,28,9,8,3239,3228,1507027,813194,758291,716769,563456,150313,224428,224264,11/01/2023 05:43:00 AM,11/01/2023 07:28:13 AM,11/01/2023 08:15:11 AM
2022/11/18,All Providers,156,70,213,25,8,14,3785,3775,1507183,813264,758504,716794,563464,150327,228213,228039,11/01/2023 05:43:00 AM,11/01/2023 07:28:13 AM,11/01/2023 08:15:11 AM
2022/11/19,All Providers,37,19,69,23,6,14,1318,1316,1507220,813283,758573,716817,563470,150341,229531,229355,11/01/2023 05:43:00 AM,11/01/2023 07:28:13 AM,11/01/2023 08:15:11 AM
2022/11/20,All Providers,4,2,22,5,0,3,632,627,1507224,813285,758595,716822,563470,150344,230163,229982,11/01/2023 05:43:00 AM,11/01/2023 07:28:13 AM,11/01/2023 08:15:11 AM
2022/11/21,All Providers,100,51,165,35,13,18,2917,2910,1507324,813336,758760,716857,563483,150362,233080,232892,11/01/2023 05:43:00 AM,11/01/2023 07:28:13 AM,11/01/2023 08:15:11 AM
2022/11/22,All Providers,85,58,111,24,10,9,2872,2869,1507409,813394,758871,716881,563493,150371,235952,235761,11/01/2023 05:43:00 AM,11/01/2023 07:28:13 AM,11/01/2023 08:15:11 AM
2022/11/23,All Providers,108,71,126,22,5,8,2742,2734,1507517,813465,758997,716903,563498,150379,238694,238495,11/01/2023 05:43:00 AM,11/01/2023 07:28:13 AM,11/01/2023 08:15:11 AM
2022/11/24,All Providers,2,2,1,0,0,0,49,48,1507519,813467,758998,716903,563498,150379,238743,238543,11/01/2023 05:43:00 AM,11/01/2023 07:28:13 AM,11/01/2023 08:15:11 AM
2022/11/25,All Providers,28,17,48,10,1,6,1199,1195,1507547,813484,759046,716913,563499,150385,239942,239738,11/01/2023 05:43:00 AM,11/01/2023 07:28:13 AM,11/01/2023 08:15:11 AM
2022/11/26,All Providers,47,22,57,18,5,9,1227,1219,1507594,813506,759103,716931,563504,150394,241169,240957,11/01/2023 05:43:00 AM,11/01/2023 07:28:13 AM,11/01/2023 08:15:11 AM
2022/11/27,All Providers,0,0,25,0,0,0,559,558,1507594,813506,759128,716931,563504,150394,241728,241515,11/01/2023 05:43:00 AM,11/01/2023 07:28:13 AM,11/01/2023 08:15:11 AM
2022/11/28,All Providers,129,80,140,19,2,10,2774,2767,1507723,813586,759268,716950,563506,150404,244502,244282,11/01/2023 05:43:00 AM,11/01/2023 07:28:13 AM,11/01/2023 08:15:11 AM
2022/11/29,All Providers,108,58,114,14,5,7,2388,2377,1507831,813644,759382,716964,563511,150411,246890,246659,11/01/2023 05:43:00 AM,11/01/2023 07:28:13 AM,11/01/2023 08:15:11 AM
2022/11/30,All Providers,136,81,141,20,3,10,2880,2877,1507967,813725,759523,716984,563514,150421,249770,249536,11/01/2023 05:43:00 AM,11/01/2023 07:28:13 AM,11/01/2023 08:15:11 AM
2022/12/01,All Providers,82,43,137,19,3,9,2480,2471,1508049,813768,759660,717003,563517,150430,252250,252007,11/01/2023 05:43:00 AM,11/01/2023 07:28:13 AM,11/01/2023 08:15:11 AM
2022/12/02,All Providers,163,80,175,18,2,9,3039,3026,1508212,813848,759835,717021,563519,150439,255289,255033,11/01/2023 05:43:00 AM,11/01/2023 07:28:13 AM,11/01/2023 08:15:11 AM
2022/12/03,All Providers,49,28,56,15,4,9,1142,1138,1508261,813876,759891,717036,563523,150448,256431,256171,11/01/2023 05:43:00 AM,11/01/2023 07:28:13 AM,11/01/2023 08:15:11 AM
2022/12/04,All Providers,5,2,27,0,0,0,542,540,1508266,813878,759918,717036,563523,150448,256973,256711,11/01/2023 05:43:00 AM,11/01/2023 07:28:13 AM,11/01/2023 08:15:11 AM
2022/12/05,All Providers,112,66,125,18,4,9,2359,2355,1508378,813944,760043,717054,563527,150457,259332,259066,11/01/2023 05:43:00 AM,11/01/2023 07:28:13 AM,11/01/2023 08:15:11 AM
2022/12/06,All Providers,99,57,124,17,3,2,2286,2279,1508477,814001,760167,717071,563530,150459,261618,261345,11/01/2023 05:43:00 AM,11/01/2023 07:28:13 AM,11/01/2023 08:15:11 AM
2022/12/07,All Providers,108,59,135,12,3,6,2535,2525,1508585,814060,760302,717083,563533,150465,264153,263870,11/01/2023 05:43:00 AM,11/01/2023 07:28:13 AM,11/01/2023 08:15:11 AM
2022/12/08,All Providers,95,51,116,16,3,9,2320,2311,1508680,814111,760418,717099,563536,150474,266473,266181,11/01/2023 05:43:00 AM,11/01/2023 07:28:13 AM,11/01/2023 08:15:11 AM
2022/12/09,All Providers,189,99,178,16,3,8,2891,2876,1508869,814210,760596,717115,563539,150482,269364,269057,11/01/2023 05:43:00 AM,11/01/2023 07:28:13 AM,11/01/2023 08:15:11 AM
2022/12/10,All Providers,20,8,37,9,1,8,836,835,1508889,814218,760633,717124,563540,150490,270200,269892,11/01/2023 05:43:00 AM,11/01/2023 07:28:13 AM,11/01/2023 08:15:11 AM
2022/12/11,All Providers,2,1,29,0,0,0,532,528,1508891,814219,760662,717124,563540,150490,270732,270420,11/01/2023 05:43:00 AM,11/01/2023 07:28:13 AM,11/01/2023 08:15:11 AM
2022/12/12,All Providers,108,62,127,16,4,7,2419,2407,1508999,814281,760789,717140,563544,150497,273151,272827,11/01/2023 05:43:00 AM,11/01/2023 07:28:13 AM,11/01/2023 08:15:11 AM
2022/12/13,All Providers,86,53,96,8,3,2,2018,2013,1509085,814334,760885,717148,563547,150499,275169,274840,11/01/2023 05:43:00 AM,11/01/2023 07:28:13 AM,11/01/2023 08:15:11 AM
2022/12/14,All Providers,103,59,120,12,3,6,2289,2276,1509188,814393,761005,717160,563550,150505,277458,277116,11/01/2023 05:43:00 AM,11/01/2023 07:28:13 AM,11/01/2023 08:15:11 AM
2022/12/15,All Providers,125,76,114,27,5,17,2173,2163,1509313,814469,761119,717187,563555,150522,279631,279279,11/01/2023 05:43:00 AM,11/01/2023 07:28:13 AM,11/01/2023 08:15:11 AM
2022/12/16,All Providers,157,98,132,19,3,10,2514,2495,1509470,814567,761251,717206,563558,150532,282145,281774,11/01/2023 05:43:00 AM,11/01/2023 07:28:13 AM,11/01/2023 08:15:11 AM
2022/12/17,All Providers,27,18,44,11,2,8,1052,1044,1509497,814585,761295,717217,563560,150540,283197,282818,11/01/2023 05:43:00 AM,11/01/2023 07:28:13 AM,11/01/2023 08:15:11 AM
2022/12/18,All Providers,8,7,28,2,1,1,514,512,1509505,814592,761323,717219,563561,150541,283711,283330,11/01/2023 05:43:00 AM,11/01/2023 07:28:13 AM,11/01/2023 08:15:11 AM
2022/12/19,All Providers,114,57,141,19,3,15,2424,2415,1509619,814649,761464,717238,563564,150556,286135,285745,11/01/2023 05:43:00 AM,11/01/2023 07:28:13 AM,11/01/2023 08:15:11 AM
2022/12/20,All Providers,92,46,129,12,3,5,2001,1985,1509711,814695,761593,717250,563567,150561,288136,287730,11/01/2023 05:43:00 AM,11/01/2023 07:28:13 AM,11/01/2023 08:15:11 AM
2022/12/21,All Providers,87,50,106,10,1,5,2019,2005,1509798,814745,761699,717260,563568,150566,290155,289735,11/01/2023 05:43:00 AM,11/01/2023 07:28:13 AM,11/01/2023 08:15:11 AM
2022/12/22,All Providers,76,35,83,12,4,4,1668,1657,1509874,814780,761782,717272,563572,150570,291823,291392,11/01/2023 05:43:00 AM,11/01/2023 07:28:13 AM,11/01/2023 08:15:11 AM
2022/12/23,All Providers,90,50,79,3,2,1,1534,1525,1509964,814830,761861,717275,563574,150571,293357,292917,11/01/2023 05:43:00 AM,11/01/2023 07:28:13 AM,11/01/2023 08:15:11 AM
2022/12/24,All Providers,2,2,7,1,0,1,146,146,1509966,814832,761868,717276,563574,150572,293503,293063,11/01/2023 05:43:00 AM,11/01/2023 07:28:13 AM,11/01/2023 08:15:11 AM
2022/12/25,All Providers,1,1,0,0,0,0,1,1,1509967,814833,761868,717276,563574,150572,293504,293064,11/01/2023 05:43:00 AM,11/01/2023 07:28:13 AM,11/01/2023 08:15:11 AM
2022/12/26,All Providers,17,9,40,5,0,2,657,653,1509984,814842,761908,717281,563574,150574,294161,293717,11/01/2023 05:43:00 AM,11/01/2023 07:28:13 AM,11/01/2023 08:15:11 AM
2022/12/27,All Providers,63,34,89,6,3,3,1510,1497,1510047,814876,761997,717287,563577,150577,295671,295214,11/01/2023 05:43:00 AM,11/01/2023 07:28:13 AM,11/01/2023 08:15:11 AM
2022/12/28,All Providers,67,38,73,8,3,1,1565,1556,1510114,814914,762070,717295,563580,150578,297236,296770,11/01/2023 05:43:00 AM,11/01/2023 07:28:13 AM,11/01/2023 08:15:11 AM
2022/12/29,All Providers,77,38,82,9,0,5,1466,1455,1510191,814952,762152,717304,563580,150583,298702,298225,11/01/2023 05:43:00 AM,11/01/2023 07:28:13 AM,11/01/2023 08:15:11 AM
2022/12/30,All Providers,104,39,107,3,1,2,1370,1362,1510295,814991,762259,717307,563581,150585,300072,299587,11/01/2023 05:43:00 AM,11/01/2023 07:28:13 AM,11/01/2023 08:15:11 AM
2022/12/31,All Providers,0,0,3,0,0,0,151,148,1510295,814991,762262,717307,563581,150585,300223,299735,11/01/2023 05:43:00 AM,11/01/2023 07:28:13 AM,11/01/2023 08:15:11 AM
2023/01/01,All Providers,0,0,0,1,0,1,8,7,1510295,814991,762262,717308,563581,150586,300231,299742,11/01/2023 05:43:00 AM,11/01/2023 07:28:13 AM,11/01/2023 08:15:11 AM
2023/01/02,All Providers,23,11,34,2,0,1,601,593,1510318,815002,762296,717310,563581,150587,300832,300335,11/01/2023 05:43:00 AM,11/01/2023 07:28:13 AM,11/01/2023 08:15:11 AM
2023/01/03,All Providers,89,45,77,5,3,1,1147,1136,1510407,815047,762373,717315,563584,150588,301979,301471,11/01/2023 05:43:00 AM,11/01/2023 07:28:13 AM,11/01/2023 08:15:11 AM
2023/01/04,All Providers,54,31,56,1,0,1,974,964,1510461,815078,762429,717316,563584,150589,302953,302435,11/01/2023 05:43:00 AM,11/01/2023 07:28:13 AM,11/01/2023 08:15:11 AM
2023/01/05,All Providers,63,32,64,3,0,3,948,942,1510524,815110,762493,717319,563584,150592,303901,303377,11/01/2023 05:43:00 AM,11/01/2023 07:28:13 AM,11/01/2023 08:15:11 AM
2023/01/06,All Providers,137,69,118,6,0,3,1613,1604,1510661,815179,762611,717325,563584,150595,305514,304981,11/01/2023 05:43:00 AM,11/01/2023 07:28:13 AM,11/01/2023 08:15:11 AM
2023/01/07,All Providers,28,20,35,1,0,1,667,656,1510689,815199,762646,717326,563584,150596,306181,305637,11/01/2023 05:43:00 AM,11/01/2023 07:28:13 AM,11/01/2023 08:15:11 AM
2023/01/08,All Providers,7,3,23,1,0,1,262,259,1510696,815202,762669,717327,563584,150597,306443,305896,11/01/2023 05:43:00 AM,11/01/2023 07:28:13 AM,11/01/2023 08:15:11 AM
2023/01/09,All Providers,83,43,81,6,4,2,1086,1074,1510779,815245,762750,717333,563588,150599,307529,306970,11/01/2023 05:43:00 AM,11/01/2023 07:28:13 AM,11/01/2023 08:15:11 AM
2023/01/10,All Providers,65,35,54,5,0,4,836,824,1510844,815280,762804,717338,563588,150603,308365,307794,11/01/2023 05:43:00 AM,11/01/2023 07:28:13 AM,11/01/2023 08:15:11 AM
2023/01/11,All Providers,102,61,62,1,0,0,1040,1025,1510946,815341,762866,717339,563588,150603,309405,308819,11/01/2023 05:43:00 AM,11/01/2023 07:28:13 AM,11/01/2023 08:15:11 AM
2023/01/12,All Providers,73,38,69,6,1,2,1080,1058,1511019,815379,762935,717345,563589,150605,310485,309877,11/01/2023 05:43:00 AM,11/01/2023 07:28:13 AM,11/01/2023 08:15:11 AM
2023/01/13,All Providers,142,78,88,2,1,0,1261,1247,1511161,815457,763023,717347,563590,150605,311746,311124,11/01/2023 05:43:00 AM,11/01/2023 07:28:13 AM,11/01/2023 08:15:11 AM
2023/01/14,All Providers,19,5,24,0,0,0,470,467,1511180,815462,763047,717347,563590,150605,312216,311591,11/01/2023 05:43:00 AM,11/01/2023 07:28:13 AM,11/01/2023 08:15:11 AM
2023/01/15,All Providers,3,3,13,0,0,0,218,212,1511183,815465,763060,717347,563590,150605,312434,311803,11/01/2023 05:43:00 AM,11/01/2023 07:28:13 AM,11/01/2023 08:15:11 AM
2023/01/16,All Providers,39,25,37,1,1,0,510,502,1511222,815490,763097,717348,563591,150605,312944,312305,11/01/2023 05:43:00 AM,11/01/2023 07:28:13 AM,11/01/2023 08:15:11 AM
2023/01/17,All Providers,61,30,65,2,0,2,830,825,1511283,815520,763162,717350,563591,150607,313774,313130,11/01/2023 05:43:00 AM,11/01/2023 07:28:13 AM,11/01/2023 08:15:11 AM
2023/01/18,All Providers,84,45,70,6,3,1,950,940,1511367,815565,763232,717356,563594,150608,314724,314070,11/01/2023 05:43:00 AM,11/01/2023 07:28:13 AM,11/01/2023 08:15:11 AM
2023/01/19,All Providers,101,47,82,4,1,3,946,938,1511468,815612,763314,717360,563595,150611,315670,315008,11/01/2023 05:43:00 AM,11/01/2023 07:28:13 AM,11/01/2023 08:15:11 AM
2023/01/20,All Providers,124,65,86,6,1,2,844,834,1511592,815677,763400,717366,563596,150613,316514,315842,11/01/2023 05:43:00 AM,11/01/2023 07:28:13 AM,11/01/2023 08:15:11 AM
2023/01/21,All Providers,19,9,22,2,1,1,313,307,1511611,815686,763422,717368,563597,150614,316827,316149,11/01/2023 05:43:00 AM,11/01/2023 07:28:13 AM,11/01/2023 08:15:11 AM
2023/01/22,All Providers,5,3,8,1,0,1,107,105,1511616,815689,763430,717369,563597,150615,316934,316254,11/01/2023 05:43:00 AM,11/01/2023 07:28:13 AM,11/01/2023 08:15:11 AM
2023/01/23,All Providers,60,34,54,5,3,1,614,611,1511676,815723,763484,717374,563600,150616,317548,316865,11/01/2023 05:43:00 AM,11/01/2023 07:28:13 AM,11/01/2023 08:15:11 AM
2023/01/24,All Providers,72,41,57,2,2,0,593,584,1511748,815764,763541,717376,563602,150616,318141,317449,11/01/2023 05:43:00 AM,11/01/2023 07:28:13 AM,11/01/2023 08:15:11 AM
2023/01/25,All Providers,61,31,52,7,0,3,783,774,1511809,815795,763593,717383,563602,150619,318924,318223,11/01/2023 05:43:00 AM,11/01/2023 07:28:13 AM,11/01/2023 08:15:11 AM
2023/01/26,All Providers,68,35,61,5,2,1,819,803,1511877,815830,763654,717388,563604,150620,319743,319026,11/01/2023 05:43:00 AM,11/01/2023 07:28:13 AM,11/01/2023 08:15:11 AM
2023/01/27,All Providers,109,54,73,4,2,0,771,764,1511986,815884,763727,717392,563606,150620,320514,319790,11/01/2023 05:43:00 AM,11/01/2023 07:28:13 AM,11/01/2023 08:15:11 AM
2023/01/28,All Providers,26,8,29,2,1,0,293,286,1512012,815892,763756,717394,563607,150620,320807,320076,11/01/2023 05:43:00 AM,11/01/2023 07:28:13 AM,11/01/2023 08:15:11 AM
2023/01/29,All Providers,5,4,6,0,0,0,113,111,1512017,815896,763762,717394,563607,150620,320920,320187,11/01/2023 05:43:00 AM,11/01/2023 07:28:13 AM,11/01/2023 08:15:11 AM
2023/01/30,All Providers,62,31,53,5,0,2,641,635,1512079,815927,763815,717399,563607,150622,321561,320822,11/01/2023 05:43:00 AM,11/01/2023 07:28:13 AM,11/01/2023 08:15:11 AM
2023/01/31,All Providers,66,33,51,5,1,2,580,568,1512145,815960,763866,717404,563608,150624,322141,321390,11/01/2023 05:43:00 AM,11/01/2023 07:28:13 AM,11/01/2023 08:15:11 AM
2023/02/01,All Providers,65,34,56,5,2,0,675,666,1512210,815994,763922,717409,563610,150624,322816,322056,11/01/2023 05:43:00 AM,11/01/2023 07:28:13 AM,11/01/2023 08:15:11 AM
2023/02/02,All Providers,55,28,50,3,1,2,559,550,1512265,816022,763972,717412,563611,150626,323375,322606,11/01/2023 05:43:00 AM,11/01/2023 07:28:13 AM,11/01/2023 08:15:11 AM
2023/02/03,All Providers,81,39,71,2,1,1,652,644,1512346,816061,764043,717414,563612,150627,324027,323250,11/01/2023 05:43:00 AM,11/01/2023 07:28:13 AM,11/01/2023 08:15:11 AM
2023/02/04,All Providers,21,11,27,1,0,1,239,235,1512367,816072,764070,717415,563612,150628,324266,323485,11/01/2023 05:43:00 AM,11/01/2023 07:28:13 AM,11/01/2023 08:15:11 AM
2023/02/05,All Providers,2,1,5,0,0,0,130,124,1512369,816073,764075,717415,563612,150628,324396,323609,11/01/2023 05:43:00 AM,11/01/2023 07:28:13 AM,11/01/2023 08:15:11 AM
2023/02/06,All Providers,37,15,32,3,0,0,500,489,1512406,816088,764107,717418,563612,150628,324896,324098,11/01/2023 05:43:00 AM,11/01/2023 07:28:13 AM,11/01/2023 08:15:11 AM
2023/02/07,All Providers,53,31,31,5,1,4,496,484,1512459,816119,764138,717423,563613,150632,325392,324582,11/01/2023 05:43:00 AM,11/01/2023 07:28:13 AM,11/01/2023 08:15:11 AM
2023/02/08,All Providers,58,34,46,3,1,2,625,616,1512517,816153,764184,717426,563614,150634,326017,325198,11/01/2023 05:43:00 AM,11/01/2023 07:28:13 AM,11/01/2023 08:15:11 AM
2023/02/09,All Providers,90,52,51,7,4,3,529,519,1512607,816205,764235,717433,563618,150637,326546,325717,11/01/2023 05:43:00 AM,11/01/2023 07:28:13 AM,11/01/2023 08:15:11 AM
2023/02/10,All Providers,83,34,66,5,2,3,570,562,1512690,816239,764301,717438,563620,150640,327116,326279,11/01/2023 05:43:00 AM,11/01/2023 07:28:13 AM,11/01/2023 08:15:11 AM
2023/02/11,All Providers,36,16,28,1,0,1,293,285,1512726,816255,764329,717439,563620,150641,327409,326564,11/01/2023 05:43:00 AM,11/01/2023 07:28:13 AM,11/01/2023 08:15:11 AM
2023/02/12,All Providers,6,3,9,1,0,1,81,80,1512732,816258,764338,717440,563620,150642,327490,326644,11/01/2023 05:43:00 AM,11/01/2023 07:28:13 AM,11/01/2023 08:15:11 AM
2023/02/13,All Providers,64,38,32,5,1,2,452,441,1512796,816296,764370,717445,563621,150644,327942,327085,11/01/2023 05:43:00 AM,11/01/2023 07:28:13 AM,11/01/2023 08:15:11 AM
2023/02/14,All Providers,45,27,34,4,2,2,372,364,1512841,816323,764404,717449,563623,150646,328314,327449,11/01/2023 05:43:00 AM,11/01/2023 07:28:13 AM,11/01/2023 08:15:11 AM
2023/02/15,All Providers,63,35,42,10,1,4,484,475,1512904,816358,764446,717459,563624,150650,328798,327924,11/01/2023 05:43:00 AM,11/01/2023 07:28:13 AM,11/01/2023 08:15:11 AM
2023/02/16,All Providers,57,23,45,3,3,0,459,450,1512961,816381,764491,717462,563627,150650,329257,328374,11/01/2023 05:43:00 AM,11/01/2023 07:28:13 AM,11/01/2023 08:15:11 AM
2023/02/17,All Providers,96,46,65,5,2,0,510,506,1513057,816427,764556,717467,563629,150650,329767,328880,11/01/2023 05:43:00 AM,11/01/2023 07:28:13 AM,11/01/2023 08:15:11 AM
2023/02/18,All Providers,18,13,10,2,1,1,240,236,1513075,816440,764566,717469,563630,150651,330007,329116,11/01/2023 05:43:00 AM,11/01/2023 07:28:13 AM,11/01/2023 08:15:11 AM
2023/02/19,All Providers,4,3,4,0,0,0,60,60,1513079,816443,764570,717469,563630,150651,330067,329176,11/01/2023 05:43:00 AM,11/01/2023 07:28:13 AM,11/01/2023 08:15:11 AM
2023/02/20,All Providers,8,2,11,0,0,0,145,141,1513087,816445,764581,717469,563630,150651,330212,329317,11/01/2023 05:43:00 AM,11/01/2023 07:28:13 AM,11/01/2023 08:15:11 AM
2023/02/21,All Providers,49,31,35,3,0,2,369,360,1513136,816476,764616,717472,563630,150653,330581,329677,11/01/2023 05:43:00 AM,11/01/2023 07:28:13 AM,11/01/2023 08:15:11 AM
2023/02/22,All Providers,62,33,36,4,0,1,386,376,1513198,816509,764652,717476,563630,150654,330967,330053,11/01/2023 05:43:00 AM,11/01/2023 07:28:13 AM,11/01/2023 08:15:11 AM
2023/02/23,All Providers,60,39,31,3,1,2,429,414,1513258,816548,764683,717479,563631,150656,331396,330467,11/01/2023 05:43:00 AM,11/01/2023 07:28:13 AM,11/01/2023 08:15:11 AM
2023/02/24,All Providers,89,48,49,7,1,2,389,382,1513347,816596,764732,717486,563632,150658,331785,330849,11/01/2023 05:43:00 AM,11/01/2023 07:28:13 AM,11/01/2023 08:15:11 AM
2023/02/25,All Providers,17,8,17,5,1,2,243,233,1513364,816604,764749,717491,563633,150660,332028,331082,11/01/2023 05:43:00 AM,11/01/2023 07:28:13 AM,11/01/2023 08:15:11 AM
2023/02/26,All Providers,2,2,4,0,0,0,60,54,1513366,816606,764753,717491,563633,150660,332088,331136,11/01/2023 05:43:00 AM,11/01/2023 07:28:13 AM,11/01/2023 08:15:11 AM
2023/02/27,All Providers,49,26,36,2,1,1,357,351,1513415,816632,764789,717493,563634,150661,332445,331487,11/01/2023 05:43:00 AM,11/01/2023 07:28:13 AM,11/01/2023 08:15:11 AM
2023/02/28,All Providers,45,25,27,5,3,2,334,325,1513460,816657,764816,717498,563637,150663,332779,331812,11/01/2023 05:43:00 AM,11/01/2023 07:28:13 AM,11/01/2023 08:15:11 AM
2023/03/01,All Providers,69,29,56,3,0,0,369,359,1513529,816686,764872,717501,563637,150663,333148,332171,11/01/2023 05:43:00 AM,11/01/2023 07:28:13 AM,11/01/2023 08:15:11 AM
2023/03/02,All Providers,52,27,40,2,1,0,366,360,1513581,816713,764912,717503,563638,150663,333514,332531,11/01/2023 05:43:00 AM,11/01/2023 07:28:13 AM,11/01/2023 08:15:11 AM
2023/03/03,All Providers,59,32,35,4,3,1,421,411,1513640,816745,764947,717507,563641,150664,333935,332942,11/01/2023 05:43:00 AM,11/01/2023 07:28:13 AM,11/01/2023 08:15:11 AM
2023/03/04,All Providers,21,10,17,2,1,1,172,160,1513661,816755,764964,717509,563642,150665,334107,333102,11/01/2023 05:43:00 AM,11/01/2023 07:28:13 AM,11/01/2023 08:15:11 AM
2023/03/05,All Providers,1,1,2,1,1,0,68,65,1513662,816756,764966,717510,563643,150665,334175,333167,11/01/2023 05:43:00 AM,11/01/2023 07:28:13 AM,11/01/2023 08:15:11 AM
2023/03/06,All Providers,45,26,26,1,0,0,334,326,1513707,816782,764992,717511,563643,150665,334509,333493,11/01/2023 05:43:00 AM,11/01/2023 07:28:13 AM,11/01/2023 08:15:11 AM
2023/03/07,All Providers,43,19,26,2,0,1,313,304,1513750,816801,765018,717513,563643,150666,334822,333797,11/01/2023 05:43:00 AM,11/01/2023 07:28:13 AM,11/01/2023 08:15:11 AM
2023/03/08,All Providers,52,31,27,6,2,3,329,322,1513802,816832,765045,717519,563645,150669,335151,334119,11/01/2023 05:43:00 AM,11/01/2023 07:28:13 AM,11/01/2023 08:15:11 AM
2023/03/09,All Providers,47,26,29,4,2,0,352,335,1513849,816858,765074,717523,563647,150669,335503,334454,11/01/2023 05:43:00 AM,11/01/2023 07:28:13 AM,11/01/2023 08:15:11 AM
2023/03/10,All Providers,76,29,63,2,0,0,453,445,1513925,816887,765137,717525,563647,150669,335956,334899,11/01/2023 05:43:00 AM,11/01/2023 07:28:13 AM,11/01/2023 08:15:11 AM
2023/03/11,All Providers,10,3,11,2,1,1,181,178,1513935,816890,765148,717527,563648,150670,336137,335077,11/01/2023 05:43:00 AM,11/01/2023 07:28:13 AM,11/01/2023 08:15:11 AM
2023/03/12,All Providers,2,2,2,0,0,0,63,59,1513937,816892,765150,717527,563648,150670,336200,335136,11/01/2023 05:43:00 AM,11/01/2023 07:28:13 AM,11/01/2023 08:15:11 AM
2023/03/13,All Providers,40,22,26,2,1,1,306,294,1513977,816914,765176,717529,563649,150671,336506,335430,11/01/2023 05:43:00 AM,11/01/2023 07:28:13 AM,11/01/2023 08:15:11 AM
2023/03/14,All Providers,54,29,33,4,1,1,269,265,1514031,816943,765209,717533,563650,150672,336775,335695,11/01/2023 05:43:00 AM,11/01/2023 07:28:13 AM,11/01/2023 08:15:11 AM
2023/03/15,All Providers,62,39,33,4,1,1,288,279,1514093,816982,765242,717537,563651,150673,337063,335974,11/01/2023 05:43:00 AM,11/01/2023 07:28:13 AM,11/01/2023 08:15:11 AM
2023/03/16,All Providers,54,28,33,3,1,1,387,376,1514147,817010,765275,717540,563652,150674,337450,336350,11/01/2023 05:43:00 AM,11/01/2023 07:28:13 AM,11/01/2023 08:15:11 AM
2023/03/17,All Providers,68,34,46,3,2,1,341,330,1514215,817044,765321,717543,563654,150675,337791,336680,11/01/2023 05:43:00 AM,11/01/2023 07:28:13 AM,11/01/2023 08:15:11 AM
2023/03/18,All Providers,20,11,15,3,3,0,161,155,1514235,817055,765336,717546,563657,150675,337952,336835,11/01/2023 05:43:00 AM,11/01/2023 07:28:13 AM,11/01/2023 08:15:11 AM
2023/03/19,All Providers,2,1,6,0,0,0,91,83,1514237,817056,765342,717546,563657,150675,338043,336918,11/01/2023 05:43:00 AM,11/01/2023 07:28:13 AM,11/01/2023 08:15:11 AM
2023/03/20,All Providers,29,18,21,0,0,0,279,271,1514266,817074,765363,717546,563657,150675,338322,337189,11/01/2023 05:43:00 AM,11/01/2023 07:28:13 AM,11/01/2023 08:15:11 AM
2023/03/21,All Providers,53,27,35,5,1,3,258,245,1514319,817101,765398,717551,563658,150678,338580,337434,11/01/2023 05:43:00 AM,11/01/2023 07:28:13 AM,11/01/2023 08:15:11 AM
2023/03/22,All Providers,47,23,30,1,0,0,271,262,1514366,817124,765428,717552,563658,150678,338851,337696,11/01/2023 05:43:00 AM,11/01/2023 07:28:13 AM,11/01/2023 08:15:11 AM
2023/03/23,All Providers,47,21,30,3,0,3,265,254,1514413,817145,765458,717555,563658,150681,339116,337950,11/01/2023 05:43:00 AM,11/01/2023 07:28:13 AM,11/01/2023 08:15:11 AM
2023/03/24,All Providers,58,30,39,1,0,1,326,313,1514471,817175,765497,717556,563658,150682,339442,338263,11/01/2023 05:43:00 AM,11/01/2023 07:28:13 AM,11/01/2023 08:15:11 AM
2023/03/25,All Providers,14,8,10,0,0,0,112,107,1514485,817183,765507,717556,563658,150682,339554,338370,11/01/2023 05:43:00 AM,11/01/2023 07:28:13 AM,11/01/2023 08:15:11 AM
2023/03/26,All Providers,2,2,9,0,0,0,72,68,1514487,817185,765516,717556,563658,150682,339626,338438,11/01/2023 05:43:00 AM,11/01/2023 07:28:13 AM,11/01/2023 08:15:11 AM
2023/03/27,All Providers,55,28,34,2,0,1,289,281,1514542,817213,765550,717558,563658,150683,339915,338719,11/01/2023 05:43:00 AM,11/01/2023 07:28:13 AM,11/01/2023 08:15:11 AM
2023/03/28,All Providers,30,10,29,1,1,0,246,238,1514572,817223,765579,717559,563659,150683,340161,338957,11/01/2023 05:43:00 AM,11/01/2023 07:28:13 AM,11/01/2023 08:15:11 AM
2023/03/29,All Providers,50,25,30,3,1,0,297,289,1514622,817248,765609,717562,563660,150683,340458,339246,11/01/2023 05:43:00 AM,11/01/2023 07:28:13 AM,11/01/2023 08:15:11 AM
2023/03/30,All Providers,47,16,39,2,2,0,309,296,1514669,817264,765648,717564,563662,150683,340767,339542,11/01/2023 05:43:00 AM,11/01/2023 07:28:13 AM,11/01/2023 08:15:11 AM
2023/03/31,All Providers,61,29,39,0,0,0,304,298,1514730,817293,765687,717564,563662,150683,341071,339840,11/01/2023 05:43:00 AM,11/01/2023 07:28:13 AM,11/01/2023 08:15:11 AM
2023/04/01,All Providers,21,13,12,0,0,0,92,87,1514751,817306,765699,717564,563662,150683,341163,339927,11/01/2023 05:43:00 AM,11/01/2023 07:28:13 AM,11/01/2023 08:15:11 AM
2023/04/02,All Providers,2,2,2,0,0,0,40,38,1514753,817308,765701,717564,563662,150683,341203,339965,11/01/2023 05:43:00 AM,11/01/2023 07:28:13 AM,11/01/2023 08:15:11 AM
2023/04/03,All Providers,35,17,27,1,0,1,257,247,1514788,817325,765728,717565,563662,150684,341460,340212,11/01/2023 05:43:00 AM,11/01/2023 07:28:13 AM,11/01/2023 08:15:11 AM
2023/04/04,All Providers,38,19,30,7,2,4,221,213,1514826,817344,765758,717572,563664,150688,341681,340425,11/01/2023 05:43:00 AM,11/01/2023 07:28:13 AM,11/01/2023 08:15:11 AM
2023/04/05,All Providers,41,26,21,1,0,1,260,256,1514867,817370,765779,717573,563664,150689,341941,340681,11/01/2023 05:43:00 AM,11/01/2023 07:28:13 AM,11/01/2023 08:15:11 AM
2023/04/06,All Providers,59,36,38,2,1,1,252,243,1514926,817406,765817,717575,563665,150690,342193,340924,11/01/2023 05:43:00 AM,11/01/2023 07:28:13 AM,11/01/2023 08:15:11 AM
2023/04/07,All Providers,57,36,26,3,0,0,300,290,1514983,817442,765843,717578,563665,150690,342493,341214,11/01/2023 05:43:00 AM,11/01/2023 07:28:13 AM,11/01/2023 08:15:11 AM
2023/04/08,All Providers,15,8,9,1,0,0,95,92,1514998,817450,765852,717579,563665,150690,342588,341306,11/01/2023 05:43:00 AM,11/01/2023 07:28:13 AM,11/01/2023 08:15:11 AM
2023/04/09,All Providers,1,1,1,0,0,0,35,33,1514999,817451,765853,717579,563665,150690,342623,341339,11/01/2023 05:43:00 AM,11/01/2023 07:28:13 AM,11/01/2023 08:15:11 AM
2023/04/10,All Providers,45,19,37,5,2,3,215,201,1515044,817470,765890,717584,563667,150693,342838,341540,11/01/2023 05:43:00 AM,11/01/2023 07:28:13 AM,11/01/2023 08:15:11 AM
2023/04/11,All Providers,31,21,15,7,2,1,233,224,1515075,817491,765905,717591,563669,150694,343071,341764,11/01/2023 05:43:00 AM,11/01/2023 07:28:13 AM,11/01/2023 08:15:11 AM
2023/04/12,All Providers,35,21,23,2,0,1,215,208,1515110,817512,765928,717593,563669,150695,343286,341972,11/01/2023 05:43:00 AM,11/01/2023 07:28:13 AM,11/01/2023 08:15:11 AM
2023/04/13,All Providers,48,24,26,2,1,1,231,227,1515158,817536,765954,717595,563670,150696,343517,342199,11/01/2023 05:43:00 AM,11/01/2023 07:28:13 AM,11/01/2023 08:15:11 AM
2023/04/14,All Providers,55,26,33,1,0,1,241,229,1515213,817562,765987,717596,563670,150697,343758,342428,11/01/2023 05:43:00 AM,11/01/2023 07:28:13 AM,11/01/2023 08:15:11 AM
2023/04/15,All Providers,15,8,13,0,0,0,77,72,1515228,817570,766000,717596,563670,150697,343835,342500,11/01/2023 05:43:00 AM,11/01/2023 07:28:13 AM,11/01/2023 08:15:11 AM
2023/04/16,All Providers,3,2,4,0,0,0,35,33,1515231,817572,766004,717596,563670,150697,343870,342533,11/01/2023 05:43:00 AM,11/01/2023 07:28:13 AM,11/01/2023 08:15:11 AM
2023/04/17,All Providers,44,23,26,0,0,0,258,253,1515275,817595,766030,717596,563670,150697,344128,342786,11/01/2023 05:43:00 AM,11/01/2023 07:28:13 AM,11/01/2023 08:15:11 AM
2023/04/18,All Providers,28,16,21,5,1,2,247,233,1515303,817611,766051,717601,563671,150699,344375,343019,11/01/2023 05:43:00 AM,11/01/2023 07:28:13 AM,11/01/2023 08:15:11 AM
2023/04/19,All Providers,7,4,7,4,1,1,290,261,1515310,817615,766058,717605,563672,150700,344665,343280,11/01/2023 05:43:00 AM,11/01/2023 07:28:13 AM,11/01/2023 08:15:11 AM
2023/04/20,All Providers,7,5,12,3,0,1,527,265,1515317,817620,766070,717608,563672,150701,345192,343545,11/01/2023 05:43:00 AM,11/01/2023 07:28:13 AM,11/01/2023 08:15:11 AM
2023/04/21,All Providers,2,2,9,2,0,0,612,269,1515319,817622,766079,717610,563672,150701,345804,343814,11/01/2023 05:43:00 AM,11/01/2023 07:28:13 AM,11/01/2023 08:15:11 AM
2023/04/22,All Providers,0,0,6,0,0,0,419,126,1515319,817622,766085,717610,563672,150701,346223,343940,11/01/2023 05:43:00 AM,11/01/2023 07:28:13 AM,11/01/2023 08:15:11 AM
2023/04/23,All Providers,0,0,4,0,0,0,198,49,1515319,817622,766089,717610,563672,150701,346421,343989,11/01/2023 05:43:00 AM,11/01/2023 07:28:13 AM,11/01/2023 08:15:11 AM
2023/04/24,All Providers,3,3,14,7,0,2,646,255,1515322,817625,766103,717617,563672,150703,347067,344244,11/01/2023 05:43:00 AM,11/01/2023 07:28:13 AM,11/01/2023 08:15:11 AM
2023/04/25,All Providers,1,1,11,0,0,0,526,216,1515323,817626,766114,717617,563672,150703,347593,344460,11/01/2023 05:43:00 AM,11/01/2023 07:28:13 AM,11/01/2023 08:15:11 AM
2023/04/26,All Providers,2,1,14,6,0,0,781,276,1515325,817627,766128,717623,563672,150703,348374,344736,11/01/2023 05:43:00 AM,11/01/2023 07:28:13 AM,11/01/2023 08:15:11 AM
2023/04/27,All Providers,1,1,19,8,1,2,804,337,1515326,817628,766147,717631,563673,150705,349178,345073,11/01/2023 05:43:00 AM,11/01/2023 07:28:13 AM,11/01/2023 08:15:11 AM
2023/04/28,All Providers,5,0,18,9,2,1,849,286,1515331,817628,766165,717640,563675,150706,350027,345359,11/01/2023 05:43:00 AM,11/01/2023 07:28:13 AM,11/01/2023 08:15:11 AM
2023/04/29,All Providers,2,0,5,8,1,2,97,45,1515333,817628,766170,717648,563676,150708,350124,345404,11/01/2023 05:43:00 AM,11/01/2023 07:28:13 AM,11/01/2023 08:15:11 AM
2023/04/30,All Providers,0,0,2,1,1,0,110,37,1515333,817628,766172,717649,563677,150708,350234,345441,11/01/2023 05:43:00 AM,11/01/2023 07:28:13 AM,11/01/2023 08:15:11 AM
2023/05/01,All Providers,3,3,7,1,0,1,762,242,1515336,817631,766179,717650,563677,150709,350996,345683,11/01/2023 05:43:00 AM,11/01/2023 07:28:13 AM,11/01/2023 08:15:11 AM
2023/05/02,All Providers,1,1,11,1,0,1,745,266,1515337,817632,766190,717651,563677,150710,351741,345949,11/01/2023 05:43:00 AM,11/01/2023 07:28:13 AM,11/01/2023 08:15:11 AM
2023/05/03,All Providers,2,1,7,2,0,0,1042,270,1515339,817633,766197,717653,563677,150710,352783,346219,11/01/2023 05:43:00 AM,11/01/2023 07:28:13 AM,11/01/2023 08:15:11 AM
2023/05/04,All Providers,2,2,11,3,0,1,826,273,1515341,817635,766208,717656,563677,150711,353609,346492,11/01/2023 05:43:00 AM,11/01/2023 07:28:13 AM,11/01/2023 08:15:11 AM
2023/05/05,All Providers,0,0,15,5,0,0,923,287,1515341,817635,766223,717661,563677,150711,354532,346779,11/01/2023 05:43:00 AM,11/01/2023 07:28:13 AM,11/01/2023 08:15:11 AM
2023/05/06,All Providers,0,0,16,1,0,1,353,131,1515341,817635,766239,717662,563677,150712,354885,346910,11/01/2023 05:43:00 AM,11/01/2023 07:28:13 AM,11/01/2023 08:15:11 AM
2023/05/07,All Providers,0,0,2,0,0,0,168,59,1515341,817635,766241,717662,563677,150712,355053,346969,11/01/2023 05:43:00 AM,11/01/2023 07:28:13 AM,11/01/2023 08:15:11 AM
2023/05/08,All Providers,2,1,17,8,0,1,1034,270,1515343,817636,766258,717670,563677,150713,356087,347239,11/01/2023 05:43:00 AM,11/01/2023 07:28:13 AM,11/01/2023 08:15:11 AM
2023/05/09,All Providers,1,1,6,5,1,1,839,272,1515344,817637,766264,717675,563678,150714,356926,347511,11/01/2023 05:43:00 AM,11/01/2023 07:28:13 AM,11/01/2023 08:15:11 AM
2023/05/10,All Providers,0,0,15,6,0,4,1152,357,1515344,817637,766279,717681,563678,150718,358078,347868,11/01/2023 05:43:00 AM,11/01/2023 07:28:13 AM,11/01/2023 08:15:11 AM
2023/05/11,All Providers,0,0,8,1,0,0,825,263,1515344,817637,766287,717682,563678,150718,358903,348131,11/01/2023 05:43:00 AM,11/01/2023 07:28:13 AM,11/01/2023 08:15:11 AM
2023/05/12,All Providers,2,0,10,9,0,1,854,299,1515346,817637,766297,717691,563678,150719,359757,348430,11/01/2023 05:43:00 AM,11/01/2023 07:28:13 AM,11/01/2023 08:15:11 AM
2023/05/13,All Providers,0,0,5,0,0,0,228,96,1515346,817637,766302,717691,563678,150719,359985,348526,11/01/2023 05:43:00 AM,11/01/2023 07:28:13 AM,11/01/2023 08:15:11 AM
2023/05/14,All Providers,0,0,2,1,0,0,106,38,1515346,817637,766304,717692,563678,150719,360091,348564,11/01/2023 05:43:00 AM,11/01/2023 07:28:13 AM,11/01/2023 08:15:11 AM
2023/05/15,All Providers,3,3,14,5,0,1,648,224,1515349,817640,766318,717697,563678,150720,360739,348788,11/01/2023 05:43:00 AM,11/01/2023 07:28:13 AM,11/01/2023 08:15:11 AM
2023/05/16,All Providers,0,0,6,1,0,1,720,223,1515349,817640,766324,717698,563678,150721,361459,349011,11/01/2023 05:43:00 AM,11/01/2023 07:28:13 AM,11/01/2023 08:15:11 AM
2023/05/17,All Providers,0,0,14,1,1,0,690,284,1515349,817640,766338,717699,563679,150721,362149,349295,11/01/2023 05:43:00 AM,11/01/2023 07:28:13 AM,11/01/2023 08:15:11 AM
2023/05/18,All Providers,2,2,12,4,0,1,742,273,1515351,817642,766350,717703,563679,150722,362891,349568,11/01/2023 05:43:00 AM,11/01/2023 07:28:13 AM,11/01/2023 08:15:11 AM
2023/05/19,All Providers,0,0,8,3,0,0,659,255,1515351,817642,766358,717706,563679,150722,363550,349823,11/01/2023 05:43:00 AM,11/01/2023 07:28:13 AM,11/01/2023 08:15:11 AM
2023/05/20,All Providers,0,0,2,0,0,0,213,86,1515351,817642,766360,717706,563679,150722,363763,349909,11/01/2023 05:43:00 AM,11/01/2023 07:28:13 AM,11/01/2023 08:15:11 AM
2023/05/21,All Providers,0,0,2,0,0,0,92,42,1515351,817642,766362,717706,563679,150722,363855,349951,11/01/2023 05:43:00 AM,11/01/2023 07:28:13 AM,11/01/2023 08:15:11 AM
2023/05/22,All Providers,2,1,14,2,0,0,638,243,1515353,817643,766376,717708,563679,150722,364493,350194,11/01/2023 05:43:00 AM,11/01/2023 07:28:13 AM,11/01/2023 08:15:11 AM
2023/05/23,All Providers,7,4,13,3,2,1,559,212,1515360,817647,766389,717711,563681,150723,365052,350406,11/01/2023 05:43:00 AM,11/01/2023 07:28:13 AM,11/01/2023 08:15:11 AM
2023/05/24,All Providers,0,0,20,3,0,0,642,296,1515360,817647,766409,717714,563681,150723,365694,350702,11/01/2023 05:43:00 AM,11/01/2023 07:28:13 AM,11/01/2023 08:15:11 AM
2023/05/25,All Providers,1,0,20,1,0,1,592,245,1515361,817647,766429,717715,563681,150724,366286,350947,11/01/2023 05:43:00 AM,11/01/2023 07:28:13 AM,11/01/2023 08:15:11 AM
2023/05/26,All Providers,3,0,20,6,0,2,581,216,1515364,817647,766449,717721,563681,150726,366867,351163,11/01/2023 05:43:00 AM,11/01/2023 07:28:13 AM,11/01/2023 08:15:11 AM
2023/05/27,All Providers,0,0,6,0,0,0,206,95,1515364,817647,766455,717721,563681,150726,367073,351258,11/01/2023 05:43:00 AM,11/01/2023 07:28:13 AM,11/01/2023 08:15:11 AM
2023/05/28,All Providers,0,0,7,1,0,0,123,42,1515364,817647,766462,717722,563681,150726,367196,351300,11/01/2023 05:43:00 AM,11/01/2023 07:28:13 AM,11/01/2023 08:15:11 AM
2023/05/29,All Providers,0,0,0,0,0,0,4,3,1515364,817647,766462,717722,563681,150726,367200,351303,11/01/2023 05:43:00 AM,11/01/2023 07:28:13 AM,11/01/2023 08:15:11 AM
2023/05/30,All Providers,1,1,17,3,1,1,693,249,1515365,817648,766479,717725,563682,150727,367893,351552,11/01/2023 05:43:00 AM,11/01/2023 07:28:13 AM,11/01/2023 08:15:10 AM
2023/05/31,All Providers,2,2,12,9,1,1,574,234,1515367,817650,766491,717734,563683,150728,368467,351786,11/01/2023 05:43:00 AM,11/01/2023 07:28:13 AM,11/01/2023 08:15:10 AM
2023/06/01,All Providers,0,0,14,2,1,1,516,202,1515367,817650,766505,717736,563684,150729,368983,351988,11/01/2023 05:43:00 AM,11/01/2023 07:28:13 AM,11/01/2023 08:15:10 AM
2023/06/02,All Providers,1,1,9,3,0,1,564,201,1515368,817651,766514,717739,563684,150730,369547,352189,11/01/2023 05:43:00 AM,11/01/2023 07:28:13 AM,11/01/2023 08:15:10 AM
2023/06/03,All Providers,0,0,7,0,0,0,172,87,1515368,817651,766521,717739,563684,150730,369719,352276,11/01/2023 05:43:00 AM,11/01/2023 07:28:13 AM,11/01/2023 08:15:10 AM
2023/06/04,All Providers,1,0,1,1,0,0,104,51,1515369,817651,766522,717740,563684,150730,369823,352327,11/01/2023 05:43:00 AM,11/01/2023 07:28:13 AM,11/01/2023 08:15:10 AM
2023/06/05,All Providers,0,0,15,0,0,0,524,199,1515369,817651,766537,717740,563684,150730,370347,352526,11/01/2023 05:43:00 AM,11/01/2023 07:28:13 AM,11/01/2023 08:15:10 AM
2023/06/06,All Providers,1,0,9,3,0,0,514,230,1515370,817651,766546,717743,563684,150730,370861,352756,11/01/2023 05:43:00 AM,11/01/2023 07:28:13 AM,11/01/2023 08:15:10 AM
2023/06/07,All Providers,0,0,10,1,1,0,458,204,1515370,817651,766556,717744,563685,150730,371319,352960,11/01/2023 05:43:00 AM,11/01/2023 07:28:13 AM,11/01/2023 08:15:10 AM
2023/06/08,All Providers,0,0,14,3,0,1,417,215,1515370,817651,766570,717747,563685,150731,371736,353175,11/01/2023 05:43:00 AM,11/01/2023 07:28:13 AM,11/01/2023 08:15:10 AM
2023/06/09,All Providers,1,1,12,0,0,0,511,222,1515371,817652,766582,717747,563685,150731,372247,353397,11/01/2023 05:43:00 AM,11/01/2023 07:28:13 AM,11/01/2023 08:15:10 AM
2023/06/10,All Providers,0,0,4,0,0,0,135,76,1515371,817652,766586,717747,563685,150731,372382,353473,11/01/2023 05:43:00 AM,11/01/2023 07:28:13 AM,11/01/2023 08:15:10 AM
2023/06/11,All Providers,0,0,4,0,0,0,72,33,1515371,817652,766590,717747,563685,150731,372454,353506,11/01/2023 05:43:00 AM,11/01/2023 07:28:13 AM,11/01/2023 08:15:10 AM
2023/06/12,All Providers,1,1,10,2,0,1,488,219,1515372,817653,766600,717749,563685,150732,372942,353725,11/01/2023 05:43:00 AM,11/01/2023 07:28:13 AM,11/01/2023 08:15:10 AM
2023/06/13,All Providers,2,0,17,0,0,0,454,202,1515374,817653,766617,717749,563685,150732,373396,353927,11/01/2023 05:43:00 AM,11/01/2023 07:28:13 AM,11/01/2023 08:15:10 AM
2023/06/14,All Providers,0,0,5,1,0,0,432,191,1515374,817653,766622,717750,563685,150732,373828,354118,11/01/2023 05:43:00 AM,11/01/2023 07:28:13 AM,11/01/2023 08:15:10 AM
2023/06/15,All Providers,2,2,10,1,1,0,438,216,1515376,817655,766632,717751,563686,150732,374266,354334,11/01/2023 05:43:00 AM,11/01/2023 07:28:13 AM,11/01/2023 08:15:10 AM
2023/06/16,All Providers,0,0,14,1,1,0,476,206,1515376,817655,766646,717752,563687,150732,374742,354540,11/01/2023 05:43:00 AM,11/01/2023 07:28:13 AM,11/01/2023 08:15:10 AM
2023/06/17,All Providers,0,0,10,1,0,1,199,99,1515376,817655,766656,717753,563687,150733,374941,354639,11/01/2023 05:43:00 AM,11/01/2023 07:28:13 AM,11/01/2023 08:15:10 AM
2023/06/18,All Providers,0,0,0,0,0,0,45,22,1515376,817655,766656,717753,563687,150733,374986,354661,11/01/2023 05:43:00 AM,11/01/2023 07:28:13 AM,11/01/2023 08:15:10 AM
2023/06/19,All Providers,0,0,6,1,0,1,351,145,1515376,817655,766662,717754,563687,150734,375337,354806,11/01/2023 05:43:00 AM,11/01/2023 07:28:13 AM,11/01/2023 08:15:10 AM
2023/06/20,All Providers,1,1,9,2,0,2,386,183,1515377,817656,766671,717756,563687,150736,375723,354989,11/01/2023 05:43:00 AM,11/01/2023 07:28:13 AM,11/01/2023 08:15:10 AM
2023/06/21,All Providers,0,0,6,4,1,1,419,185,1515377,817656,766677,717760,563688,150737,376142,355174,11/01/2023 05:43:00 AM,11/01/2023 07:28:13 AM,11/01/2023 08:15:10 AM
2023/06/22,All Providers,0,0,21,0,0,0,541,283,1515377,817656,766698,717760,563688,150737,376683,355457,11/01/2023 05:43:00 AM,11/01/2023 07:28:13 AM,11/01/2023 08:15:10 AM
2023/06/23,All Providers,0,0,19,0,0,0,416,217,1515377,817656,766717,717760,563688,150737,377099,355674,11/01/2023 05:43:00 AM,11/01/2023 07:28:13 AM,11/01/2023 08:15:10 AM
2023/06/24,All Providers,0,0,4,0,0,0,110,59,1515377,817656,766721,717760,563688,150737,377209,355733,11/01/2023 05:43:00 AM,11/01/2023 07:28:13 AM,11/01/2023 08:15:10 AM
2023/06/25,All Providers,0,0,1,0,0,0,26,15,1515377,817656,766722,717760,563688,150737,377235,355748,11/01/2023 05:43:00 AM,11/01/2023 07:28:13 AM,11/01/2023 08:15:10 AM
2023/06/26,All Providers,1,0,19,0,0,0,372,184,1515378,817656,766741,717760,563688,150737,377607,355932,11/01/2023 05:43:00 AM,11/01/2023 07:28:13 AM,11/01/2023 08:15:10 AM
2023/06/27,All Providers,0,0,7,1,1,0,350,148,1515378,817656,766748,717761,563689,150737,377957,356080,11/01/2023 05:43:00 AM,11/01/2023 07:28:13 AM,11/01/2023 08:15:10 AM
2023/06/28,All Providers,0,0,8,1,0,0,335,147,1515378,817656,766756,717762,563689,150737,378292,356227,11/01/2023 05:43:00 AM,11/01/2023 07:28:13 AM,11/01/2023 08:15:10 AM
2023/06/29,All Providers,0,0,16,0,0,0,361,195,1515378,817656,766772,717762,563689,150737,378653,356422,11/01/2023 05:43:00 AM,11/01/2023 07:28:13 AM,11/01/2023 08:15:10 AM
2023/06/30,All Providers,0,0,9,0,0,0,401,209,1515378,817656,766781,717762,563689,150737,379054,356631,11/01/2023 05:43:00 AM,11/01/2023 07:28:13 AM,11/01/2023 08:15:10 AM
2023/07/01,All Providers,0,0,5,0,0,0,76,44,1515378,817656,766786,717762,563689,150737,379130,356675,11/01/2023 05:43:00 AM,11/01/2023 07:28:13 AM,11/01/2023 08:15:10 AM
2023/07/02,All Providers,0,0,0,0,0,0,36,16,1515378,817656,766786,717762,563689,150737,379166,356691,11/01/2023 05:43:00 AM,11/01/2023 07:28:13 AM,11/01/2023 08:15:10 AM
2023/07/03,All Providers,0,0,7,1,1,0,284,133,1515378,817656,766793,717763,563690,150737,379450,356824,11/01/2023 05:43:00 AM,11/01/2023 07:28:13 AM,11/01/2023 08:15:10 AM
2023/07/04,All Providers,0,0,0,0,0,0,2,2,1515378,817656,766793,717763,563690,150737,379452,356826,11/01/2023 05:43:00 AM,11/01/2023 07:28:13 AM,11/01/2023 08:15:10 AM
2023/07/05,All Providers,1,1,14,1,0,0,361,176,1515379,817657,766807,717764,563690,150737,379813,357002,11/01/2023 05:43:00 AM,11/01/2023 07:28:13 AM,11/01/2023 08:15:10 AM
2023/07/06,All Providers,0,0,7,0,0,0,356,163,1515379,817657,766814,717764,563690,150737,380169,357165,11/01/2023 05:43:00 AM,11/01/2023 07:28:13 AM,11/01/2023 08:15:10 AM
2023/07/07,All Providers,0,0,12,0,0,0,388,203,1515379,817657,766826,717764,563690,150737,380557,357368,11/01/2023 05:43:00 AM,11/01/2023 07:28:13 AM,11/01/2023 08:15:10 AM
2023/07/08,All Providers,0,0,2,0,0,0,101,62,1515379,817657,766828,717764,563690,150737,380658,357430,11/01/2023 05:43:00 AM,11/01/2023 07:28:13 AM,11/01/2023 08:15:10 AM
2023/07/09,All Providers,0,0,0,0,0,0,30,13,1515379,817657,766828,717764,563690,150737,380688,357443,11/01/2023 05:43:00 AM,11/01/2023 07:28:13 AM,11/01/2023 08:15:10 AM
2023/07/10,All Providers,0,0,8,0,0,0,340,144,1515379,817657,766836,717764,563690,150737,381028,357587,11/01/2023 05:43:00 AM,11/01/2023 07:28:13 AM,11/01/2023 08:15:10 AM
2023/07/11,All Providers,0,0,13,0,0,0,315,156,1515379,817657,766849,717764,563690,150737,381343,357743,11/01/2023 05:43:00 AM,11/01/2023 07:28:13 AM,11/01/2023 08:15:10 AM
2023/07/12,All Providers,1,1,11,1,0,0,360,177,1515380,817658,766860,717765,563690,150737,381703,357920,11/01/2023 05:43:00 AM,11/01/2023 07:28:13 AM,11/01/2023 08:15:10 AM
2023/07/13,All Providers,0,0,10,0,0,0,365,170,1515380,817658,766870,717765,563690,150737,382068,358090,11/01/2023 05:43:00 AM,11/01/2023 07:28:13 AM,11/01/2023 08:15:10 AM
2023/07/14,All Providers,0,0,8,2,2,0,335,132,1515380,817658,766878,717767,563692,150737,382403,358222,11/01/2023 05:43:00 AM,11/01/2023 07:28:13 AM,11/01/2023 08:15:10 AM
2023/07/15,All Providers,0,0,5,0,0,0,82,45,1515380,817658,766883,717767,563692,150737,382485,358267,11/01/2023 05:43:00 AM,11/01/2023 07:28:13 AM,11/01/2023 08:15:10 AM
2023/07/16,All Providers,0,0,0,0,0,0,30,6,1515380,817658,766883,717767,563692,150737,382515,358273,11/01/2023 05:43:00 AM,11/01/2023 07:28:13 AM,11/01/2023 08:15:10 AM
2023/07/17,All Providers,0,0,8,2,0,0,338,144,1515380,817658,766891,717769,563692,150737,382853,358417,11/01/2023 05:43:00 AM,11/01/2023 07:28:13 AM,11/01/2023 08:15:10 AM
2023/07/18,All Providers,0,0,9,1,0,1,315,125,1515380,817658,766900,717770,563692,150738,383168,358542,11/01/2023 05:43:00 AM,11/01/2023 07:28:13 AM,11/01/2023 08:15:10 AM
2023/07/19,All Providers,0,0,13,1,0,0,403,156,1515380,817658,766913,717771,563692,150738,383571,358698,11/01/2023 05:43:00 AM,11/01/2023 07:28:13 AM,11/01/2023 08:15:10 AM
2023/07/20,All Providers,2,2,8,1,0,0,318,170,1515382,817660,766921,717772,563692,150738,383889,358868,11/01/2023 05:43:00 AM,11/01/2023 07:28:13 AM,11/01/2023 08:15:10 AM
2023/07/21,All Providers,0,0,8,1,0,0,323,155,1515382,817660,766929,717773,563692,150738,384212,359023,11/01/2023 05:43:00 AM,11/01/2023 07:28:13 AM,11/01/2023 08:15:10 AM
2023/07/22,All Providers,0,0,3,0,0,0,65,37,1515382,817660,766932,717773,563692,150738,384277,359060,11/01/2023 05:43:00 AM,11/01/2023 07:28:13 AM,11/01/2023 08:15:10 AM
2023/07/23,All Providers,0,0,0,0,0,0,25,11,1515382,817660,766932,717773,563692,150738,384302,359071,11/01/2023 05:43:00 AM,11/01/2023 07:28:13 AM,11/01/2023 08:15:10 AM
2023/07/24,All Providers,0,0,6,0,0,0,307,137,1515382,817660,766938,717773,563692,150738,384609,359208,11/01/2023 05:43:00 AM,11/01/2023 07:28:13 AM,11/01/2023 08:15:10 AM
2023/07/25,All Providers,0,0,4,0,0,0,285,114,1515382,817660,766942,717773,563692,150738,384894,359322,11/01/2023 05:43:00 AM,11/01/2023 07:28:13 AM,11/01/2023 08:15:10 AM
2023/07/26,All Providers,2,2,8,0,0,0,313,140,1515384,817662,766950,717773,563692,150738,385207,359462,11/01/2023 05:43:00 AM,11/01/2023 07:28:13 AM,11/01/2023 08:15:10 AM
2023/07/27,All Providers,1,1,12,1,1,0,301,168,1515385,817663,766962,717774,563693,150738,385508,359630,11/01/2023 05:43:00 AM,11/01/2023 07:28:13 AM,11/01/2023 08:15:10 AM
2023/07/28,All Providers,1,1,9,0,0,0,275,143,1515386,817664,766971,717774,563693,150738,385783,359773,11/01/2023 05:43:00 AM,11/01/2023 07:28:13 AM,11/01/2023 08:15:10 AM
2023/07/29,All Providers,1,1,4,0,0,0,81,54,1515387,817665,766975,717774,563693,150738,385864,359827,11/01/2023 05:43:00 AM,11/01/2023 07:28:13 AM,11/01/2023 08:15:10 AM
2023/07/30,All Providers,0,0,4,0,0,0,81,39,1515387,817665,766979,717774,563693,150738,385945,359866,11/01/2023 05:43:00 AM,11/01/2023 07:28:13 AM,11/01/2023 08:15:10 AM
2023/07/31,All Providers,0,0,3,1,0,1,281,132,1515387,817665,766982,717775,563693,150739,386226,359998,11/01/2023 05:43:00 AM,11/01/2023 07:28:13 AM,11/01/2023 08:15:10 AM
2023/08/01,All Providers,0,0,14,0,0,0,323,167,1515387,817665,766996,717775,563693,150739,386549,360165,11/01/2023 05:43:00 AM,11/01/2023 07:28:13 AM,11/01/2023 08:15:10 AM
2023/08/02,All Providers,1,1,13,0,0,0,303,166,1515388,817666,767009,717775,563693,150739,386852,360331,11/01/2023 05:43:00 AM,11/01/2023 07:28:13 AM,11/01/2023 08:15:10 AM
2023/08/03,All Providers,0,0,12,0,0,0,302,142,1515388,817666,767021,717775,563693,150739,387154,360473,11/01/2023 05:43:00 AM,11/01/2023 07:28:13 AM,11/01/2023 08:15:10 AM
2023/08/04,All Providers,0,0,9,0,0,0,340,142,1515388,817666,767030,717775,563693,150739,387494,360615,11/01/2023 05:43:00 AM,11/01/2023 07:28:13 AM,11/01/2023 08:15:10 AM
2023/08/05,All Providers,2,2,2,2,0,1,89,50,1515390,817668,767032,717777,563693,150740,387583,360665,11/01/2023 05:43:00 AM,11/01/2023 07:28:13 AM,11/01/2023 08:15:10 AM
2023/08/06,All Providers,0,0,3,0,0,0,39,16,1515390,817668,767035,717777,563693,150740,387622,360681,11/01/2023 05:43:00 AM,11/01/2023 07:28:13 AM,11/01/2023 08:15:10 AM
2023/08/07,All Providers,0,0,7,0,0,0,291,140,1515390,817668,767042,717777,563693,150740,387913,360821,11/01/2023 05:43:00 AM,11/01/2023 07:28:13 AM,11/01/2023 08:15:10 AM
2023/08/08,All Providers,0,0,8,4,1,1,281,125,1515390,817668,767050,717781,563694,150741,388194,360946,11/01/2023 05:43:00 AM,11/01/2023 07:28:13 AM,11/01/2023 08:15:10 AM
2023/08/09,All Providers,0,0,15,1,0,0,362,197,1515390,817668,767065,717782,563694,150741,388556,361143,11/01/2023 05:43:00 AM,11/01/2023 07:28:13 AM,11/01/2023 08:15:10 AM
2023/08/10,All Providers,1,0,9,0,0,0,316,167,1515391,817668,767074,717782,563694,150741,388872,361310,11/01/2023 05:43:00 AM,11/01/2023 07:28:13 AM,11/01/2023 08:15:10 AM
2023/08/11,All Providers,0,0,14,2,0,1,274,138,1515391,817668,767088,717784,563694,150742,389146,361448,11/01/2023 05:43:00 AM,11/01/2023 07:28:13 AM,11/01/2023 08:15:10 AM
2023/08/12,All Providers,0,0,0,0,0,0,79,47,1515391,817668,767088,717784,563694,150742,389225,361495,11/01/2023 05:43:00 AM,11/01/2023 07:28:13 AM,11/01/2023 08:15:10 AM
2023/08/13,All Providers,0,0,2,0,0,0,39,20,1515391,817668,767090,717784,563694,150742,389264,361515,11/01/2023 05:43:00 AM,11/01/2023 07:28:13 AM,11/01/2023 08:15:10 AM
2023/08/14,All Providers,0,0,9,2,0,1,309,152,1515391,817668,767099,717786,563694,150743,389573,361667,11/01/2023 05:43:00 AM,11/01/2023 07:28:13 AM,11/01/2023 08:15:10 AM
2023/08/15,All Providers,0,0,9,0,0,0,282,161,1515391,817668,767108,717786,563694,150743,389855,361828,11/01/2023 05:43:00 AM,11/01/2023 07:28:13 AM,11/01/2023 08:15:10 AM
2023/08/16,All Providers,0,0,10,0,0,0,266,126,1515391,817668,767118,717786,563694,150743,390121,361954,11/01/2023 05:43:00 AM,11/01/2023 07:28:13 AM,11/01/2023 08:15:10 AM
2023/08/17,All Providers,1,1,8,3,0,0,310,138,1515392,817669,767126,717789,563694,150743,390431,362092,11/01/2023 05:43:00 AM,11/01/2023 07:28:13 AM,11/01/2023 08:15:10 AM
2023/08/18,All Providers,1,0,11,0,0,0,286,154,1515393,817669,767137,717789,563694,150743,390717,362246,11/01/2023 05:43:00 AM,11/01/2023 07:28:13 AM,11/01/2023 08:15:10 AM
2023/08/19,All Providers,0,0,0,0,0,0,78,49,1515393,817669,767137,717789,563694,150743,390795,362295,11/01/2023 05:43:00 AM,11/01/2023 07:28:13 AM,11/01/2023 08:15:10 AM
2023/08/20,All Providers,0,0,0,0,0,0,38,20,1515393,817669,767137,717789,563694,150743,390833,362315,11/01/2023 05:43:00 AM,11/01/2023 07:28:13 AM,11/01/2023 08:15:10 AM
2023/08/21,All Providers,0,0,6,0,0,0,238,122,1515393,817669,767143,717789,563694,150743,391071,362437,11/01/2023 05:43:00 AM,11/01/2023 07:28:13 AM,11/01/2023 08:15:10 AM
2023/08/22,All Providers,1,1,14,0,0,0,230,122,1515394,817670,767157,717789,563694,150743,391301,362559,11/01/2023 05:43:00 AM,11/01/2023 07:28:13 AM,11/01/2023 08:15:10 AM
2023/08/23,All Providers,0,0,5,0,0,0,212,115,1515394,817670,767162,717789,563694,150743,391513,362674,11/01/2023 05:43:00 AM,11/01/2023 07:28:13 AM,11/01/2023 08:15:10 AM
2023/08/24,All Providers,0,0,10,0,0,0,260,143,1515394,817670,767172,717789,563694,150743,391773,362817,11/01/2023 05:43:00 AM,11/01/2023 07:28:13 AM,11/01/2023 08:15:10 AM
2023/08/25,All Providers,0,0,15,1,0,0,266,150,1515394,817670,767187,717790,563694,150743,392039,362967,11/01/2023 05:43:00 AM,11/01/2023 07:28:13 AM,11/01/2023 08:15:10 AM
2023/08/26,All Providers,0,0,4,0,0,0,61,28,1515394,817670,767191,717790,563694,150743,392100,362995,11/01/2023 05:43:00 AM,11/01/2023 07:28:13 AM,11/01/2023 08:15:10 AM
2023/08/27,All Providers,0,0,1,0,0,0,25,14,1515394,817670,767192,717790,563694,150743,392125,363009,11/01/2023 05:43:00 AM,11/01/2023 07:28:13 AM,11/01/2023 08:15:10 AM
2023/08/28,All Providers,0,0,8,0,0,0,199,110,1515394,817670,767200,717790,563694,150743,392324,363119,11/01/2023 05:43:00 AM,11/01/2023 07:28:13 AM,11/01/2023 08:15:10 AM
2023/08/29,All Providers,0,0,6,1,0,1,175,108,1515394,817670,767206,717791,563694,150744,392499,363227,11/01/2023 05:43:00 AM,11/01/2023 07:28:13 AM,11/01/2023 08:15:10 AM
2023/08/30,All Providers,0,0,4,0,0,0,216,118,1515394,817670,767210,717791,563694,150744,392715,363345,11/01/2023 05:43:00 AM,11/01/2023 07:28:13 AM,11/01/2023 08:15:10 AM
2023/08/31,All Providers,0,0,5,0,0,0,190,112,1515394,817670,767215,717791,563694,150744,392905,363457,11/01/2023 05:43:00 AM,11/01/2023 07:28:13 AM,11/01/2023 08:15:10 AM
2023/09/01,All Providers,0,0,6,0,0,0,219,121,1515394,817670,767221,717791,563694,150744,393124,363578,11/01/2023 05:43:00 AM,11/01/2023 07:28:13 AM,11/01/2023 08:15:10 AM
2023/09/02,All Providers,0,0,2,1,0,0,57,35,1515394,817670,767223,717792,563694,150744,393181,363613,11/01/2023 05:43:00 AM,11/01/2023 07:28:13 AM,11/01/2023 08:15:10 AM
2023/09/03,All Providers,0,0,3,0,0,0,33,20,1515394,817670,767226,717792,563694,150744,393214,363633,11/01/2023 05:43:00 AM,11/01/2023 07:28:13 AM,11/01/2023 08:15:10 AM
2023/09/04,All Providers,0,0,0,0,0,0,3,3,1515394,817670,767226,717792,563694,150744,393217,363636,11/01/2023 05:43:00 AM,11/01/2023 07:28:13 AM,11/01/2023 08:15:10 AM
2023/09/05,All Providers,0,0,5,0,0,0,181,95,1515394,817670,767231,717792,563694,150744,393398,363731,11/01/2023 05:43:00 AM,11/01/2023 07:28:13 AM,11/01/2023 08:15:10 AM
2023/09/06,All Providers,1,1,4,1,1,0,202,103,1515395,817671,767235,717793,563695,150744,393600,363834,11/01/2023 05:43:00 AM,11/01/2023 07:28:13 AM,11/01/2023 08:15:10 AM
2023/09/07,All Providers,0,0,6,1,0,1,206,101,1515395,817671,767241,717794,563695,150745,393806,363935,11/01/2023 05:43:00 AM,11/01/2023 07:28:13 AM,11/01/2023 08:15:10 AM
2023/09/08,All Providers,0,0,10,0,0,0,135,81,1515395,817671,767251,717794,563695,150745,393941,364016,11/01/2023 05:43:00 AM,11/01/2023 07:28:13 AM,11/01/2023 08:15:10 AM
2023/09/09,All Providers,0,0,0,0,0,0,26,17,1515395,817671,767251,717794,563695,150745,393967,364033,11/01/2023 05:43:00 AM,11/01/2023 07:28:13 AM,11/01/2023 08:15:10 AM
2023/09/10,All Providers,0,0,0,0,0,0,40,32,1515395,817671,767251,717794,563695,150745,394007,364065,11/01/2023 05:43:00 AM,11/01/2023 07:28:13 AM,11/01/2023 08:15:10 AM
2023/09/11,All Providers,0,0,5,2,0,2,82,35,1515395,817671,767256,717796,563695,150747,394089,364100,11/01/2023 05:43:00 AM,11/01/2023 07:28:13 AM,11/01/2023 08:15:10 AM
2023/09/12,All Providers,0,0,0,0,0,0,5,3,1515395,817671,767256,717796,563695,150747,394094,364103,11/01/2023 05:43:00 AM,11/01/2023 07:28:13 AM,11/01/2023 08:15:10 AM
2023/09/13,All Providers,0,0,0,0,0,0,5,1,1515395,817671,767256,717796,563695,150747,394099,364104,11/01/2023 05:43:00 AM,11/01/2023 07:28:13 AM,11/01/2023 08:15:10 AM
2023/09/14,All Providers,0,0,1,0,0,0,1,1,1515395,817671,767257,717796,563695,150747,394100,364105,11/01/2023 05:43:00 AM,11/01/2023 07:28:13 AM,11/01/2023 08:15:10 AM
2023/09/15,All Providers,0,0,0,1,0,0,6,4,1515395,817671,767257,717797,563695,150747,394106,364109,11/01/2023 05:43:00 AM,11/01/2023 07:28:13 AM,11/01/2023 08:15:10 AM
2023/09/16,All Providers,0,0,0,0,0,0,0,0,1515395,817671,767257,717797,563695,150747,394106,364109,11/01/2023 05:43:00 AM,11/01/2023 07:28:13 AM,11/01/2023 08:15:10 AM
2023/09/17,All Providers,0,0,0,0,0,0,0,0,1515395,817671,767257,717797,563695,150747,394106,364109,11/01/2023 05:43:00 AM,11/01/2023 07:28:13 AM,11/01/2023 08:15:10 AM
2023/09/18,All Providers,0,0,0,2,0,2,0,0,1515395,817671,767257,717799,563695,150749,394106,364109,11/01/2023 05:43:00 AM,11/01/2023 07:28:13 AM,11/01/2023 08:15:10 AM
2023/09/19,All Providers,0,0,0,2,0,0,1,1,1515395,817671,767257,717801,563695,150749,394107,364110,11/01/2023 05:43:00 AM,11/01/2023 07:28:13 AM,11/01/2023 08:15:10 AM
2023/09/20,All Providers,0,0,0,2,1,0,2,2,1515395,817671,767257,717803,563696,150749,394109,364112,11/01/2023 05:43:00 AM,11/01/2023 07:28:13 AM,11/01/2023 08:15:10 AM
2023/09/21,All Providers,0,0,0,3,0,1,0,0,1515395,817671,767257,717806,563696,150750,394109,364112,11/01/2023 05:43:00 AM,11/01/2023 07:28:13 AM,11/01/2023 08:15:10 AM
2023/09/22,All Providers,0,0,0,2,1,0,2,1,1515395,817671,767257,717808,563697,150750,394111,364113,11/01/2023 05:43:00 AM,11/01/2023 07:28:13 AM,11/01/2023 08:15:10 AM
2023/09/23,All Providers,0,0,0,1,0,0,1,0,1515395,817671,767257,717809,563697,150750,394112,364113,11/01/2023 05:43:00 AM,11/01/2023 07:28:13 AM,11/01/2023 08:15:10 AM
2023/09/24,All Providers,0,0,0,1,0,1,0,0,1515395,817671,767257,717810,563697,150751,394112,364113,11/01/2023 05:43:00 AM,11/01/2023 07:28:13 AM,11/01/2023 08:15:10 AM
2023/09/25,All Providers,2,2,0,3,1,1,3,1,1515397,817673,767257,717813,563698,150752,394115,364114,11/01/2023 05:43:00 AM,11/01/2023 07:28:13 AM,11/01/2023 08:15:10 AM
2023/09/26,All Providers,0,0,0,9,0,2,0,0,1515397,817673,767257,717822,563698,150754,394115,364114,11/01/2023 05:43:00 AM,11/01/2023 07:28:13 AM,11/01/2023 08:15:10 AM
2023/09/27,All Providers,0,0,0,12,1,5,1,0,1515397,817673,767257,717834,563699,150759,394116,364114,11/01/2023 05:43:00 AM,11/01/2023 07:28:13 AM,11/01/2023 08:15:10 AM
2023/09/28,All Providers,0,0,0,0,0,0,1,0,1515397,817673,767257,717834,563699,150759,394117,364114,11/01/2023 05:43:00 AM,11/01/2023 07:28:13 AM,11/01/2023 08:15:10 AM
2023/09/29,All Providers,0,0,0,7,0,3,2,1,1515397,817673,767257,717841,563699,150762,394119,364115,11/01/2023 05:43:00 AM,11/01/2023 07:28:13 AM,11/01/2023 08:15:10 AM
2023/09/30,All Providers,0,0,0,1,0,1,1,1,1515397,817673,767257,717842,563699,150763,394120,364116,11/01/2023 05:43:00 AM,11/01/2023 07:28:13 AM,11/01/2023 08:15:10 AM
2023/10/01,All Providers,0,0,0,0,0,0,0,0,1515397,817673,767257,717842,563699,150763,394120,364116,11/01/2023 05:43:00 AM,11/01/2023 07:28:13 AM,11/01/2023 08:15:10 AM
2023/10/02,All Providers,0,0,0,0,0,0,6,3,1515397,817673,767257,717842,563699,150763,394126,364119,11/01/2023 05:43:00 AM,11/01/2023 07:28:13 AM,11/01/2023 08:15:10 AM
2023/10/03,All Providers,0,0,0,1,0,1,2,1,1515397,817673,767257,717843,563699,150764,394128,364120,11/01/2023 05:43:00 AM,11/01/2023 07:28:13 AM,11/01/2023 08:15:10 AM
2023/10/04,All Providers,0,0,0,3,0,0,0,0,1515397,817673,767257,717846,563699,150764,394128,364120,11/01/2023 05:43:00 AM,11/01/2023 07:28:13 AM,11/01/2023 08:15:10 AM
2023/10/05,All Providers,0,0,0,5,0,3,4,1,1515397,817673,767257,717851,563699,150767,394132,364121,11/01/2023 05:43:00 AM,11/01/2023 07:28:13 AM,11/01/2023 08:15:10 AM
2023/10/06,All Providers,0,0,0,5,0,0,0,0,1515397,817673,767257,717856,563699,150767,394132,364121,11/01/2023 05:43:00 AM,11/01/2023 07:28:13 AM,11/01/2023 08:15:10 AM
2023/10/07,All Providers,0,0,0,1,0,1,0,0,1515397,817673,767257,717857,563699,150768,394132,364121,11/01/2023 05:43:00 AM,11/01/2023 07:28:13 AM,11/01/2023 08:15:10 AM
2023/10/08,All Providers,0,0,0,0,0,0,0,0,1515397,817673,767257,717857,563699,150768,394132,364121,11/01/2023 05:43:00 AM,11/01/2023 07:28:13 AM,11/01/2023 08:15:10 AM
2023/10/09,All Providers,1,0,1,5,0,3,0,0,1515398,817673,767258,717862,563699,150771,394132,364121,11/01/2023 05:43:00 AM,11/01/2023 07:28:13 AM,11/01/2023 08:15:10 AM
2023/10/10,All Providers,1,0,1,2,0,2,1,1,1515399,817673,767259,717864,563699,150773,394133,364122,11/01/2023 05:43:00 AM,11/01/2023 07:28:13 AM,11/01/2023 08:15:10 AM
2023/10/11,All Providers,0,0,0,9,0,2,0,0,1515399,817673,767259,717873,563699,150775,394133,364122,11/01/2023 05:43:00 AM,11/01/2023 07:28:13 AM,11/01/2023 08:15:10 AM
2023/10/12,All Providers,0,0,1,4,0,0,8,1,1515399,817673,767260,717877,563699,150775,394141,364123,11/01/2023 05:43:00 AM,11/01/2023 07:28:13 AM,11/01/2023 08:15:10 AM
2023/10/13,All Providers,0,0,0,4,0,2,1,1,1515399,817673,767260,717881,563699,150777,394142,364124,11/01/2023 05:43:00 AM,11/01/2023 07:28:13 AM,11/01/2023 08:15:10 AM
2023/10/14,All Providers,2,1,1,4,1,2,0,0,1515401,817674,767261,717885,563700,150779,394142,364124,11/01/2023 05:43:00 AM,11/01/2023 07:28:13 AM,11/01/2023 08:15:10 AM
2023/10/15,All Providers,0,0,0,0,0,0,0,0,1515401,817674,767261,717885,563700,150779,394142,364124,11/01/2023 05:43:00 AM,11/01/2023 07:28:13 AM,11/01/2023 08:15:10 AM
2023/10/16,All Providers,0,0,0,4,0,2,1,1,1515401,817674,767261,717889,563700,150781,394143,364125,11/01/2023 05:43:00 AM,11/01/2023 07:28:13 AM,11/01/2023 08:15:10 AM
2023/10/17,All Providers,1,1,0,2,0,1,1,0,1515402,817675,767261,717891,563700,150782,394144,364125,11/01/2023 05:43:00 AM,11/01/2023 07:28:13 AM,11/01/2023 08:15:10 AM
2023/10/18,All Providers,0,0,0,1,0,0,0,0,1515402,817675,767261,717892,563700,150782,394144,364125,11/01/2023 05:43:00 AM,11/01/2023 07:28:13 AM,11/01/2023 08:15:10 AM
2023/10/19,All Providers,0,0,0,4,1,0,2,1,1515402,817675,767261,717896,563701,150782,394146,364126,11/01/2023 05:43:00 AM,11/01/2023 07:28:13 AM,11/01/2023 08:15:10 AM
2023/10/20,All Providers,0,0,0,5,1,1,0,0,1515402,817675,767261,717901,563702,150783,394146,364126,11/01/2023 05:43:00 AM,11/01/2023 07:28:13 AM,11/01/2023 08:15:10 AM
2023/10/21,All Providers,0,0,0,0,0,0,110,29,1515402,817675,767261,717901,563702,150783,394256,364155,11/01/2023 05:43:00 AM,11/01/2023 07:28:13 AM,11/01/2023 08:15:10 AM
2023/10/22,All Providers,0,0,0,0,0,0,1,0,1515402,817675,767261,717901,563702,150783,394257,364155,11/01/2023 05:43:00 AM,11/01/2023 07:28:13 AM,11/01/2023 08:15:10 AM
2023/10/23,All Providers,0,0,0,11,1,6,1,0,1515402,817675,767261,717912,563703,150789,394258,364155,11/01/2023 05:43:00 AM,11/01/2023 07:28:13 AM,11/01/2023 08:15:10 AM
2023/10/24,All Providers,0,0,0,11,0,8,1,1,1515402,817675,767261,717923,563703,150797,394259,364156,11/01/2023 05:43:00 AM,11/01/2023 07:28:13 AM,11/01/2023 08:15:10 AM
2023/10/25,All Providers,0,0,0,4,0,1,4,2,1515402,817675,767261,717927,563703,150798,394263,364158,11/01/2023 05:43:00 AM,11/01/2023 07:28:13 AM,11/01/2023 08:15:10 AM
2023/10/26,All Providers,0,0,0,8,0,3,12,3,1515402,817675,767261,717935,563703,150801,394275,364161,11/01/2023 05:43:00 AM,11/01/2023 07:28:13 AM,11/01/2023 08:15:10 AM
2023/10/27,All Providers,0,0,0,6,1,1,13,2,1515402,817675,767261,717941,563704,150802,394288,364163,11/01/2023 05:43:00 AM,11/01/2023 07:28:13 AM,11/01/2023 08:15:10 AM
2023/10/28,All Providers,0,0,3,6,1,1,106,34,1515402,817675,767264,717947,563705,150803,394394,364197,11/01/2023 05:43:00 AM,11/01/2023 07:28:13 AM,11/01/2023 08:15:10 AM
2023/10/29,All Providers,0,0,0,1,0,1,0,0,1515402,817675,767264,717948,563705,150804,394394,364197,11/01/2023 05:43:00 AM,11/01/2023 07:28:13 AM,11/01/2023 08:15:10 AM
2023/10/30,All Providers,0,0,0,5,0,1,9,2,1515402,817675,767264,717953,563705,150805,394403,364199,11/01/2023 05:43:00 AM,11/01/2023 07:28:13 AM,11/01/2023 08:15:10 AM
2023/10/31,All Providers,1,1,0,7,0,4,8,1,1515403,817676,767264,717960,563705,150809,394411,364200,11/01/2023 05:43:00 AM,11/01/2023 07:28:13 AM,11/01/2023 08:15:10 AM
2020/12/11,DPH Only,0,0,0,0,0,0,0,0,0,0,0,0,0,0,0,0,11/01/2023 05:43:00 AM,11/01/2023 07:28:13 AM,11/01/2023 08:15:10 AM
2020/12/12,DPH Only,0,0,0,0,0,0,0,0,0,0,0,0,0,0,0,0,11/01/2023 05:43:00 AM,11/01/2023 07:28:13 AM,11/01/2023 08:15:10 AM
2020/12/13,DPH Only,0,0,0,0,0,0,0,0,0,0,0,0,0,0,0,0,11/01/2023 05:43:00 AM,11/01/2023 07:28:13 AM,11/01/2023 08:15:10 AM
2020/12/14,DPH Only,0,0,0,0,0,0,0,0,0,0,0,0,0,0,0,0,11/01/2023 05:43:00 AM,11/01/2023 07:28:13 AM,11/01/2023 08:15:10 AM
2020/12/15,DPH Only,2,2,0,0,0,0,0,0,2,2,0,0,0,0,0,0,11/01/2023 05:43:00 AM,11/01/2023 07:28:13 AM,11/01/2023 08:15:10 AM
2020/12/16,DPH Only,42,42,0,0,0,0,0,0,44,44,0,0,0,0,0,0,11/01/2023 05:43:00 AM,11/01/2023 07:28:13 AM,11/01/2023 08:15:10 AM
2020/12/17,DPH Only,82,82,0,0,0,0,0,0,126,126,0,0,0,0,0,0,11/01/2023 05:43:00 AM,11/01/2023 07:28:13 AM,11/01/2023 08:15:10 AM
2020/12/18,DPH Only,122,122,0,0,0,0,0,0,248,248,0,0,0,0,0,0,11/01/2023 05:43:00 AM,11/01/2023 07:28:13 AM,11/01/2023 08:15:10 AM
2020/12/19,DPH Only,54,54,0,0,0,0,0,0,302,302,0,0,0,0,0,0,11/01/2023 05:43:00 AM,11/01/2023 07:28:13 AM,11/01/2023 08:15:10 AM
2020/12/20,DPH Only,3,3,0,0,0,0,0,0,305,305,0,0,0,0,0,0,11/01/2023 05:43:00 AM,11/01/2023 07:28:13 AM,11/01/2023 08:15:10 AM
2020/12/21,DPH Only,189,189,0,0,0,0,0,0,494,494,0,0,0,0,0,0,11/01/2023 05:43:00 AM,11/01/2023 07:28:13 AM,11/01/2023 08:15:10 AM
2020/12/22,DPH Only,267,267,0,0,0,0,0,0,761,761,0,0,0,0,0,0,11/01/2023 05:43:00 AM,11/01/2023 07:28:13 AM,11/01/2023 08:15:10 AM
2020/12/23,DPH Only,272,272,1,0,0,0,0,0,1033,1033,1,0,0,0,0,0,11/01/2023 05:43:00 AM,11/01/2023 07:28:13 AM,11/01/2023 08:15:10 AM
2020/12/24,DPH Only,238,238,0,0,0,0,0,0,1271,1271,1,0,0,0,0,0,11/01/2023 05:43:00 AM,11/01/2023 07:28:13 AM,11/01/2023 08:15:10 AM
2020/12/25,DPH Only,0,0,0,0,0,0,0,0,1271,1271,1,0,0,0,0,0,11/01/2023 05:43:00 AM,11/01/2023 07:28:13 AM,11/01/2023 08:15:10 AM
2020/12/26,DPH Only,41,41,0,0,0,0,0,0,1312,1312,1,0,0,0,0,0,11/01/2023 05:43:00 AM,11/01/2023 07:28:13 AM,11/01/2023 08:15:10 AM
2020/12/27,DPH Only,3,3,0,0,0,0,0,0,1315,1315,1,0,0,0,0,0,11/01/2023 05:43:00 AM,11/01/2023 07:28:13 AM,11/01/2023 08:15:10 AM
2020/12/28,DPH Only,267,267,3,0,0,0,0,0,1582,1582,4,0,0,0,0,0,11/01/2023 05:43:00 AM,11/01/2023 07:28:13 AM,11/01/2023 08:15:10 AM
2020/12/29,DPH Only,310,310,1,0,0,0,0,0,1892,1892,5,0,0,0,0,0,11/01/2023 05:43:00 AM,11/01/2023 07:28:13 AM,11/01/2023 08:15:10 AM
2020/12/30,DPH Only,260,260,0,0,0,0,0,0,2152,2152,5,0,0,0,0,0,11/01/2023 05:43:00 AM,11/01/2023 07:28:13 AM,11/01/2023 08:15:10 AM
2020/12/31,DPH Only,258,258,0,0,0,0,0,0,2410,2410,5,0,0,0,0,0,11/01/2023 05:43:00 AM,11/01/2023 07:28:13 AM,11/01/2023 08:15:10 AM
2021/01/01,DPH Only,6,6,1,0,0,0,0,0,2416,2416,6,0,0,0,0,0,11/01/2023 05:43:00 AM,11/01/2023 07:28:13 AM,11/01/2023 08:15:10 AM
2021/01/02,DPH Only,96,96,0,0,0,0,0,0,2512,2512,6,0,0,0,0,0,11/01/2023 05:43:00 AM,11/01/2023 07:28:13 AM,11/01/2023 08:15:10 AM
2021/01/03,DPH Only,4,4,0,0,0,0,0,0,2516,2516,6,0,0,0,0,0,11/01/2023 05:43:00 AM,11/01/2023 07:28:13 AM,11/01/2023 08:15:10 AM
2021/01/04,DPH Only,451,449,2,0,0,0,0,0,2967,2965,8,0,0,0,0,0,11/01/2023 05:43:00 AM,11/01/2023 07:28:13 AM,11/01/2023 08:15:10 AM
2021/01/05,DPH Only,552,548,4,0,0,0,0,0,3519,3513,12,0,0,0,0,0,11/01/2023 05:43:00 AM,11/01/2023 07:28:13 AM,11/01/2023 08:15:10 AM
2021/01/06,DPH Only,221,185,36,0,0,0,0,0,3740,3698,48,0,0,0,0,0,11/01/2023 05:43:00 AM,11/01/2023 07:28:13 AM,11/01/2023 08:15:10 AM
2021/01/07,DPH Only,237,169,68,0,0,0,0,0,3977,3867,116,0,0,0,0,0,11/01/2023 05:43:00 AM,11/01/2023 07:28:13 AM,11/01/2023 08:15:10 AM
2021/01/08,DPH Only,284,169,116,0,0,0,0,0,4261,4036,232,0,0,0,0,0,11/01/2023 05:43:00 AM,11/01/2023 07:28:13 AM,11/01/2023 08:15:10 AM
2021/01/09,DPH Only,93,45,49,0,0,0,0,0,4354,4081,281,0,0,0,0,0,11/01/2023 05:43:00 AM,11/01/2023 07:28:13 AM,11/01/2023 08:15:10 AM
2021/01/10,DPH Only,4,2,2,0,0,0,0,0,4358,4083,283,0,0,0,0,0,11/01/2023 05:43:00 AM,11/01/2023 07:28:13 AM,11/01/2023 08:15:10 AM
2021/01/11,DPH Only,306,119,189,0,0,0,0,0,4664,4202,472,0,0,0,0,0,11/01/2023 05:43:00 AM,11/01/2023 07:28:13 AM,11/01/2023 08:15:10 AM
2021/01/12,DPH Only,507,292,217,0,0,0,0,0,5171,4494,689,0,0,0,0,0,11/01/2023 05:43:00 AM,11/01/2023 07:28:13 AM,11/01/2023 08:15:10 AM
2021/01/13,DPH Only,672,460,212,0,0,0,0,0,5843,4954,901,0,0,0,0,0,11/01/2023 05:43:00 AM,11/01/2023 07:28:13 AM,11/01/2023 08:15:10 AM
2021/01/14,DPH Only,618,460,158,0,0,0,0,0,6461,5414,1059,0,0,0,0,0,11/01/2023 05:43:00 AM,11/01/2023 07:28:13 AM,11/01/2023 08:15:10 AM
2021/01/15,DPH Only,588,548,41,0,0,0,0,0,7049,5962,1100,0,0,0,0,0,11/01/2023 05:43:00 AM,11/01/2023 07:28:13 AM,11/01/2023 08:15:10 AM
2021/01/16,DPH Only,347,313,34,0,0,0,0,0,7396,6275,1134,0,0,0,0,0,11/01/2023 05:43:00 AM,11/01/2023 07:28:13 AM,11/01/2023 08:15:10 AM
2021/01/17,DPH Only,331,330,1,0,0,0,0,0,7727,6605,1135,0,0,0,0,0,11/01/2023 05:43:00 AM,11/01/2023 07:28:13 AM,11/01/2023 08:15:10 AM
2021/01/18,DPH Only,292,291,1,0,0,0,0,0,8019,6896,1136,0,0,0,0,0,11/01/2023 05:43:00 AM,11/01/2023 07:28:13 AM,11/01/2023 08:15:10 AM
2021/01/19,DPH Only,695,382,313,0,0,0,0,0,8714,7278,1449,0,0,0,0,0,11/01/2023 05:43:00 AM,11/01/2023 07:28:13 AM,11/01/2023 08:15:10 AM
2021/01/20,DPH Only,750,504,246,0,0,0,0,0,9464,7782,1695,0,0,0,0,0,11/01/2023 05:43:00 AM,11/01/2023 07:28:13 AM,11/01/2023 08:15:10 AM
2021/01/21,DPH Only,843,614,229,0,0,0,0,0,10307,8396,1924,0,0,0,0,0,11/01/2023 05:43:00 AM,11/01/2023 07:28:13 AM,11/01/2023 08:15:10 AM
2021/01/22,DPH Only,738,650,89,0,0,0,0,0,11045,9046,2013,0,0,0,0,0,11/01/2023 05:43:00 AM,11/01/2023 07:28:13 AM,11/01/2023 08:15:10 AM
2021/01/23,DPH Only,939,892,47,0,0,0,0,0,11984,9938,2060,0,0,0,0,0,11/01/2023 05:43:00 AM,11/01/2023 07:28:13 AM,11/01/2023 08:15:10 AM
2021/01/24,DPH Only,685,684,2,0,0,0,0,0,12669,10622,2062,0,0,0,0,0,11/01/2023 05:43:00 AM,11/01/2023 07:28:13 AM,11/01/2023 08:15:10 AM
2021/01/25,DPH Only,1362,932,435,0,0,0,0,0,14031,11554,2497,0,0,0,0,0,11/01/2023 05:43:00 AM,11/01/2023 07:28:13 AM,11/01/2023 08:15:10 AM
2021/01/26,DPH Only,1281,809,478,0,0,0,0,0,15312,12363,2975,0,0,0,0,0,11/01/2023 05:43:00 AM,11/01/2023 07:28:13 AM,11/01/2023 08:15:10 AM
2021/01/27,DPH Only,748,545,203,0,0,0,0,0,16060,12908,3178,0,0,0,0,0,11/01/2023 05:43:00 AM,11/01/2023 07:28:13 AM,11/01/2023 08:15:10 AM
2021/01/28,DPH Only,751,597,154,0,0,0,0,0,16811,13505,3332,0,0,0,0,0,11/01/2023 05:43:00 AM,11/01/2023 07:28:13 AM,11/01/2023 08:15:10 AM
2021/01/29,DPH Only,837,697,142,0,0,0,0,0,17648,14202,3474,0,0,0,0,0,11/01/2023 05:43:00 AM,11/01/2023 07:28:13 AM,11/01/2023 08:15:10 AM
2021/01/30,DPH Only,603,600,4,0,0,0,0,0,18251,14802,3478,0,0,0,0,0,11/01/2023 05:43:00 AM,11/01/2023 07:28:13 AM,11/01/2023 08:15:10 AM
2021/01/31,DPH Only,235,234,1,0,0,0,0,0,18486,15036,3479,0,0,0,0,0,11/01/2023 05:43:00 AM,11/01/2023 07:28:13 AM,11/01/2023 08:15:10 AM
2021/02/01,DPH Only,900,754,147,0,0,0,0,0,19386,15790,3626,0,0,0,0,0,11/01/2023 05:43:00 AM,11/01/2023 07:28:13 AM,11/01/2023 08:15:10 AM
2021/02/02,DPH Only,951,783,168,0,0,0,0,0,20337,16573,3794,0,0,0,0,0,11/01/2023 05:43:00 AM,11/01/2023 07:28:13 AM,11/01/2023 08:15:10 AM
2021/02/03,DPH Only,1327,1135,194,0,0,0,0,0,21664,17708,3988,0,0,0,0,0,11/01/2023 05:43:00 AM,11/01/2023 07:28:13 AM,11/01/2023 08:15:10 AM
2021/02/04,DPH Only,1065,851,215,0,0,0,0,0,22729,18559,4203,0,0,0,0,0,11/01/2023 05:43:00 AM,11/01/2023 07:28:13 AM,11/01/2023 08:15:10 AM
2021/02/05,DPH Only,1298,1059,240,0,0,0,0,0,24027,19618,4443,0,0,0,0,0,11/01/2023 05:43:00 AM,11/01/2023 07:28:13 AM,11/01/2023 08:15:10 AM
2021/02/06,DPH Only,950,950,0,0,0,0,0,0,24977,20568,4443,0,0,0,0,0,11/01/2023 05:43:00 AM,11/01/2023 07:28:13 AM,11/01/2023 08:15:10 AM
2021/02/07,DPH Only,505,504,2,0,0,0,0,0,25482,21072,4445,0,0,0,0,0,11/01/2023 05:43:00 AM,11/01/2023 07:28:13 AM,11/01/2023 08:15:10 AM
2021/02/08,DPH Only,1050,812,239,0,0,0,0,0,26532,21884,4684,0,0,0,0,0,11/01/2023 05:43:00 AM,11/01/2023 07:28:13 AM,11/01/2023 08:15:10 AM
2021/02/09,DPH Only,900,592,311,0,0,0,0,0,27432,22476,4995,0,0,0,0,0,11/01/2023 05:43:00 AM,11/01/2023 07:28:13 AM,11/01/2023 08:15:10 AM
2021/02/10,DPH Only,922,511,413,0,0,0,0,0,28354,22987,5408,0,0,0,0,0,11/01/2023 05:43:00 AM,11/01/2023 07:28:13 AM,11/01/2023 08:15:10 AM
2021/02/11,DPH Only,784,451,335,0,0,0,0,0,29138,23438,5743,0,0,0,0,0,11/01/2023 05:43:00 AM,11/01/2023 07:28:13 AM,11/01/2023 08:15:10 AM
2021/02/12,DPH Only,1021,607,417,0,0,0,0,0,30159,24045,6160,0,0,0,0,0,11/01/2023 05:43:00 AM,11/01/2023 07:28:13 AM,11/01/2023 08:15:10 AM
2021/02/13,DPH Only,572,385,189,0,0,0,0,0,30731,24430,6349,0,0,0,0,0,11/01/2023 05:43:00 AM,11/01/2023 07:28:13 AM,11/01/2023 08:15:11 AM
2021/02/14,DPH Only,635,329,307,0,0,0,0,0,31366,24759,6656,0,0,0,0,0,11/01/2023 05:43:00 AM,11/01/2023 07:28:13 AM,11/01/2023 08:15:11 AM
2021/02/15,DPH Only,486,215,272,0,0,0,0,0,31852,24974,6928,0,0,0,0,0,11/01/2023 05:43:00 AM,11/01/2023 07:28:13 AM,11/01/2023 08:15:11 AM
2021/02/16,DPH Only,926,501,436,0,0,0,0,0,32778,25475,7364,0,0,0,0,0,11/01/2023 05:43:00 AM,11/01/2023 07:28:13 AM,11/01/2023 08:15:11 AM
2021/02/17,DPH Only,824,386,439,0,0,0,0,0,33602,25861,7803,0,0,0,0,0,11/01/2023 05:43:00 AM,11/01/2023 07:28:13 AM,11/01/2023 08:15:11 AM
2021/02/18,DPH Only,1173,490,688,0,0,0,0,0,34775,26351,8491,0,0,0,0,0,11/01/2023 05:43:00 AM,11/01/2023 07:28:13 AM,11/01/2023 08:15:11 AM
2021/02/19,DPH Only,1553,740,817,0,0,0,0,0,36328,27091,9308,0,0,0,0,0,11/01/2023 05:43:00 AM,11/01/2023 07:28:13 AM,11/01/2023 08:15:11 AM
2021/02/20,DPH Only,1610,603,1017,0,0,0,0,0,37938,27694,10325,0,0,0,0,0,11/01/2023 05:43:00 AM,11/01/2023 07:28:13 AM,11/01/2023 08:15:11 AM
2021/02/21,DPH Only,1147,456,694,0,0,0,0,0,39085,28150,11019,0,0,0,0,0,11/01/2023 05:43:00 AM,11/01/2023 07:28:13 AM,11/01/2023 08:15:11 AM
2021/02/22,DPH Only,1684,512,1175,0,0,0,0,0,40769,28662,12194,0,0,0,0,0,11/01/2023 05:43:00 AM,11/01/2023 07:28:13 AM,11/01/2023 08:15:11 AM
2021/02/23,DPH Only,1530,517,1022,0,0,0,0,0,42299,29179,13216,0,0,0,0,0,11/01/2023 05:43:00 AM,11/01/2023 07:28:13 AM,11/01/2023 08:15:11 AM
2021/02/24,DPH Only,1545,717,832,0,0,0,0,0,43844,29896,14048,0,0,0,0,0,11/01/2023 05:43:00 AM,11/01/2023 07:28:13 AM,11/01/2023 08:15:11 AM
2021/02/25,DPH Only,1732,828,912,0,0,0,0,0,45576,30724,14960,0,0,0,0,0,11/01/2023 05:43:00 AM,11/01/2023 07:28:13 AM,11/01/2023 08:15:11 AM
2021/02/26,DPH Only,1945,925,1021,0,0,0,0,0,47521,31649,15981,0,0,0,0,0,11/01/2023 05:43:00 AM,11/01/2023 07:28:13 AM,11/01/2023 08:15:11 AM
2021/02/27,DPH Only,1730,858,876,0,0,0,0,0,49251,32507,16857,0,0,0,0,0,11/01/2023 05:43:00 AM,11/01/2023 07:28:13 AM,11/01/2023 08:15:11 AM
2021/02/28,DPH Only,1244,811,434,0,0,0,0,0,50495,33318,17291,0,0,0,0,0,11/01/2023 05:43:00 AM,11/01/2023 07:28:13 AM,11/01/2023 08:15:11 AM
2021/03/01,DPH Only,2062,1022,1061,0,0,0,0,0,52557,34340,18352,0,0,0,0,0,11/01/2023 05:43:00 AM,11/01/2023 07:28:13 AM,11/01/2023 08:15:11 AM
2021/03/02,DPH Only,1838,949,900,0,0,0,0,0,54395,35289,19252,0,0,0,0,0,11/01/2023 05:43:00 AM,11/01/2023 07:28:13 AM,11/01/2023 08:15:11 AM
2021/03/03,DPH Only,2192,1301,907,0,0,0,0,0,56587,36590,20159,0,0,0,0,0,11/01/2023 05:43:00 AM,11/01/2023 07:28:13 AM,11/01/2023 08:15:11 AM
2021/03/04,DPH Only,1547,890,683,0,0,0,0,0,58134,37480,20842,0,0,0,0,0,11/01/2023 05:43:00 AM,11/01/2023 07:28:13 AM,11/01/2023 08:15:11 AM
2021/03/05,DPH Only,1508,830,706,0,0,0,0,0,59642,38310,21548,0,0,0,0,0,11/01/2023 05:43:00 AM,11/01/2023 07:28:13 AM,11/01/2023 08:15:11 AM
2021/03/06,DPH Only,1487,686,808,0,0,0,0,0,61129,38996,22356,0,0,0,0,0,11/01/2023 05:43:00 AM,11/01/2023 07:28:13 AM,11/01/2023 08:15:11 AM
2021/03/07,DPH Only,1159,745,427,0,0,0,0,0,62288,39741,22783,0,0,0,0,0,11/01/2023 05:43:00 AM,11/01/2023 07:28:13 AM,11/01/2023 08:15:11 AM
2021/03/08,DPH Only,1369,1010,379,0,0,0,0,0,63657,40751,23162,0,0,0,0,0,11/01/2023 05:43:00 AM,11/01/2023 07:28:13 AM,11/01/2023 08:15:11 AM
2021/03/09,DPH Only,1679,1247,461,0,0,0,0,0,65336,41998,23623,0,0,0,0,0,11/01/2023 05:43:00 AM,11/01/2023 07:28:13 AM,11/01/2023 08:15:11 AM
2021/03/10,DPH Only,1729,1381,412,0,0,0,0,0,67065,43379,24035,0,0,0,0,0,11/01/2023 05:43:00 AM,11/01/2023 07:28:13 AM,11/01/2023 08:15:11 AM
2021/03/11,DPH Only,1743,1315,495,0,0,0,0,0,68808,44694,24530,0,0,0,0,0,11/01/2023 05:43:00 AM,11/01/2023 07:28:13 AM,11/01/2023 08:15:11 AM
2021/03/12,DPH Only,2053,1343,767,0,0,0,0,0,70861,46037,25297,0,0,0,0,0,11/01/2023 05:43:00 AM,11/01/2023 07:28:13 AM,11/01/2023 08:15:11 AM
2021/03/13,DPH Only,1738,1259,493,0,0,0,0,0,72599,47296,25790,0,0,0,0,0,11/01/2023 05:43:00 AM,11/01/2023 07:28:13 AM,11/01/2023 08:15:11 AM
2021/03/14,DPH Only,1382,896,498,0,0,0,0,0,73981,48192,26288,0,0,0,0,0,11/01/2023 05:43:00 AM,11/01/2023 07:28:13 AM,11/01/2023 08:15:11 AM
2021/03/15,DPH Only,1703,1271,466,0,0,0,0,0,75684,49463,26754,0,0,0,0,0,11/01/2023 05:43:00 AM,11/01/2023 07:28:13 AM,11/01/2023 08:15:11 AM
2021/03/16,DPH Only,1811,1217,664,0,0,0,0,0,77495,50680,27418,0,0,0,0,0,11/01/2023 05:43:00 AM,11/01/2023 07:28:13 AM,11/01/2023 08:15:11 AM
2021/03/17,DPH Only,1699,1094,664,0,0,0,0,0,79194,51774,28082,0,0,0,0,0,11/01/2023 05:43:00 AM,11/01/2023 07:28:13 AM,11/01/2023 08:15:11 AM
2021/03/18,DPH Only,1633,991,739,0,0,0,0,0,80827,52765,28821,0,0,0,0,0,11/01/2023 05:43:00 AM,11/01/2023 07:28:13 AM,11/01/2023 08:15:11 AM
2021/03/19,DPH Only,1803,1004,848,0,0,0,0,0,82630,53769,29669,0,0,0,0,0,11/01/2023 05:43:00 AM,11/01/2023 07:28:13 AM,11/01/2023 08:15:11 AM
2021/03/20,DPH Only,1643,1054,605,0,0,0,0,0,84273,54823,30274,0,0,0,0,0,11/01/2023 05:43:00 AM,11/01/2023 07:28:13 AM,11/01/2023 08:15:11 AM
2021/03/21,DPH Only,1119,614,592,0,0,0,0,0,85392,55437,30866,0,0,0,0,0,11/01/2023 05:43:00 AM,11/01/2023 07:28:13 AM,11/01/2023 08:15:11 AM
2021/03/22,DPH Only,1890,1199,757,0,0,0,0,0,87282,56636,31623,0,0,0,0,0,11/01/2023 05:43:00 AM,11/01/2023 07:28:13 AM,11/01/2023 08:15:11 AM
2021/03/23,DPH Only,1714,1009,763,0,0,0,0,0,88996,57645,32386,0,0,0,0,0,11/01/2023 05:43:00 AM,11/01/2023 07:28:13 AM,11/01/2023 08:15:11 AM
2021/03/24,DPH Only,1944,1145,978,0,0,0,0,0,90940,58790,33364,0,0,0,0,0,11/01/2023 05:43:00 AM,11/01/2023 07:28:13 AM,11/01/2023 08:15:11 AM
2021/03/25,DPH Only,2088,1280,1029,0,0,0,0,0,93028,60070,34393,0,0,0,0,0,11/01/2023 05:43:00 AM,11/01/2023 07:28:13 AM,11/01/2023 08:15:11 AM
2021/03/26,DPH Only,1989,1175,851,0,0,0,0,0,95017,61245,35244,0,0,0,0,0,11/01/2023 05:43:00 AM,11/01/2023 07:28:13 AM,11/01/2023 08:15:11 AM
2021/03/27,DPH Only,2023,1215,823,0,0,0,0,0,97040,62460,36067,0,0,0,0,0,11/01/2023 05:43:00 AM,11/01/2023 07:28:13 AM,11/01/2023 08:15:11 AM
2021/03/28,DPH Only,1416,674,762,0,0,0,0,0,98456,63134,36829,0,0,0,0,0,11/01/2023 05:43:00 AM,11/01/2023 07:28:13 AM,11/01/2023 08:15:11 AM
2021/03/29,DPH Only,2200,1116,1164,0,0,0,0,0,100656,64250,37993,0,0,0,0,0,11/01/2023 05:43:00 AM,11/01/2023 07:28:13 AM,11/01/2023 08:15:11 AM
2021/03/30,DPH Only,2215,1049,1319,0,0,0,0,0,102871,65299,39312,0,0,0,0,0,11/01/2023 05:43:00 AM,11/01/2023 07:28:13 AM,11/01/2023 08:15:11 AM
2021/03/31,DPH Only,2230,845,1470,0,0,0,0,0,105101,66144,40782,0,0,0,0,0,11/01/2023 05:43:00 AM,11/01/2023 07:28:13 AM,11/01/2023 08:15:11 AM
2021/04/01,DPH Only,2303,1181,1256,0,0,0,0,0,107404,67325,42038,0,0,0,0,0,11/01/2023 05:43:00 AM,11/01/2023 07:28:13 AM,11/01/2023 08:15:11 AM
2021/04/02,DPH Only,2570,1405,1353,0,0,0,0,0,109974,68730,43391,0,0,0,0,0,11/01/2023 05:43:00 AM,11/01/2023 07:28:13 AM,11/01/2023 08:15:11 AM
2021/04/03,DPH Only,2215,1178,1053,0,0,0,0,0,112189,69908,44444,0,0,0,0,0,11/01/2023 05:43:00 AM,11/01/2023 07:28:13 AM,11/01/2023 08:15:11 AM
2021/04/04,DPH Only,1457,597,884,0,0,0,0,0,113646,70505,45328,0,0,0,0,0,11/01/2023 05:43:00 AM,11/01/2023 07:28:13 AM,11/01/2023 08:15:11 AM
2021/04/05,DPH Only,2288,1064,1302,0,0,0,0,0,115934,71569,46630,0,0,0,0,0,11/01/2023 05:43:00 AM,11/01/2023 07:28:13 AM,11/01/2023 08:15:11 AM
2021/04/06,DPH Only,2225,928,1412,0,0,0,0,0,118159,72497,48042,0,0,0,0,0,11/01/2023 05:43:00 AM,11/01/2023 07:28:13 AM,11/01/2023 08:15:11 AM
2021/04/07,DPH Only,2098,1018,1211,0,0,0,0,0,120257,73515,49253,0,0,0,0,0,11/01/2023 05:43:00 AM,11/01/2023 07:28:13 AM,11/01/2023 08:15:11 AM
2021/04/08,DPH Only,1985,1040,1045,0,0,0,0,0,122242,74555,50298,0,0,0,0,0,11/01/2023 05:43:00 AM,11/01/2023 07:28:13 AM,11/01/2023 08:15:11 AM
2021/04/09,DPH Only,2963,2121,1262,0,0,0,0,0,125205,76676,51560,0,0,0,0,0,11/01/2023 05:43:00 AM,11/01/2023 07:28:13 AM,11/01/2023 08:15:11 AM
2021/04/10,DPH Only,2736,1769,1061,0,0,0,0,0,127941,78445,52621,0,0,0,0,0,11/01/2023 05:43:00 AM,11/01/2023 07:28:13 AM,11/01/2023 08:15:11 AM
2021/04/11,DPH Only,2124,1584,550,0,0,0,0,0,130065,80029,53171,0,0,0,0,0,11/01/2023 05:43:00 AM,11/01/2023 07:28:13 AM,11/01/2023 08:15:11 AM
2021/04/12,DPH Only,2440,1581,970,0,0,0,0,0,132505,81610,54141,0,0,0,0,0,11/01/2023 05:43:00 AM,11/01/2023 07:28:13 AM,11/01/2023 08:15:11 AM
2021/04/13,DPH Only,2259,1520,743,0,0,0,0,0,134764,83130,54884,0,0,0,0,0,11/01/2023 05:43:00 AM,11/01/2023 07:28:13 AM,11/01/2023 08:15:11 AM
2021/04/14,DPH Only,2502,1666,845,0,0,0,0,0,137266,84796,55729,0,0,0,0,0,11/01/2023 05:43:00 AM,11/01/2023 07:28:13 AM,11/01/2023 08:15:11 AM
2021/04/15,DPH Only,2300,1443,869,0,0,0,0,0,139566,86239,56598,0,0,0,0,0,11/01/2023 05:43:00 AM,11/01/2023 07:28:13 AM,11/01/2023 08:15:11 AM
2021/04/16,DPH Only,2589,1553,1047,0,0,0,0,0,142155,87792,57645,0,0,0,0,0,11/01/2023 05:43:00 AM,11/01/2023 07:28:13 AM,11/01/2023 08:15:11 AM
2021/04/17,DPH Only,2229,1114,1123,0,0,0,0,0,144384,88906,58768,0,0,0,0,0,11/01/2023 05:43:00 AM,11/01/2023 07:28:13 AM,11/01/2023 08:15:11 AM
2021/04/18,DPH Only,1247,618,636,0,0,0,0,0,145631,89524,59404,0,0,0,0,0,11/01/2023 05:43:00 AM,11/01/2023 07:28:13 AM,11/01/2023 08:15:11 AM
2021/04/19,DPH Only,1963,815,1214,0,0,0,0,0,147594,90339,60618,0,0,0,0,0,11/01/2023 05:43:00 AM,11/01/2023 07:28:13 AM,11/01/2023 08:15:11 AM
2021/04/20,DPH Only,1730,771,971,0,0,0,0,0,149324,91110,61589,0,0,0,0,0,11/01/2023 05:43:00 AM,11/01/2023 07:28:13 AM,11/01/2023 08:15:11 AM
2021/04/21,DPH Only,1507,783,745,0,0,0,0,0,150831,91893,62334,0,0,0,0,0,11/01/2023 05:43:00 AM,11/01/2023 07:28:13 AM,11/01/2023 08:15:11 AM
2021/04/22,DPH Only,1590,648,963,0,0,0,0,0,152421,92541,63297,0,0,0,0,0,11/01/2023 05:43:00 AM,11/01/2023 07:28:13 AM,11/01/2023 08:15:11 AM
2021/04/23,DPH Only,1740,614,1139,0,0,0,0,0,154161,93155,64436,0,0,0,0,0,11/01/2023 05:43:00 AM,11/01/2023 07:28:13 AM,11/01/2023 08:15:11 AM
2021/04/24,DPH Only,1726,515,1224,0,0,0,0,0,155887,93670,65660,0,0,0,0,0,11/01/2023 05:43:00 AM,11/01/2023 07:28:13 AM,11/01/2023 08:15:11 AM
2021/04/25,DPH Only,778,184,598,0,0,0,0,0,156665,93854,66258,0,0,0,0,0,11/01/2023 05:43:00 AM,11/01/2023 07:28:13 AM,11/01/2023 08:15:11 AM
2021/04/26,DPH Only,1308,373,964,0,0,0,0,0,157973,94227,67222,0,0,0,0,0,11/01/2023 05:43:00 AM,11/01/2023 07:28:13 AM,11/01/2023 08:15:11 AM
2021/04/27,DPH Only,1301,423,887,0,0,0,0,0,159274,94650,68109,0,0,0,0,0,11/01/2023 05:43:00 AM,11/01/2023 07:28:13 AM,11/01/2023 08:15:11 AM
2021/04/28,DPH Only,1287,458,836,0,0,0,0,0,160561,95108,68945,0,0,0,0,0,11/01/2023 05:43:00 AM,11/01/2023 07:28:13 AM,11/01/2023 08:15:11 AM
2021/04/29,DPH Only,1297,400,910,0,0,0,0,0,161858,95508,69855,0,0,0,0,0,11/01/2023 05:43:00 AM,11/01/2023 07:28:13 AM,11/01/2023 08:15:11 AM
2021/04/30,DPH Only,1924,435,1502,0,0,0,0,0,163782,95943,71357,0,0,0,0,0,11/01/2023 05:43:00 AM,11/01/2023 07:28:13 AM,11/01/2023 08:15:11 AM
2021/05/01,DPH Only,2060,400,1670,0,0,0,0,0,165842,96343,73027,0,0,0,0,0,11/01/2023 05:43:00 AM,11/01/2023 07:28:13 AM,11/01/2023 08:15:11 AM
2021/05/02,DPH Only,1427,174,1254,0,0,0,0,0,167269,96517,74281,0,0,0,0,0,11/01/2023 05:43:00 AM,11/01/2023 07:28:13 AM,11/01/2023 08:15:11 AM
2021/05/03,DPH Only,1810,332,1494,0,0,0,0,0,169079,96849,75775,0,0,0,0,0,11/01/2023 05:43:00 AM,11/01/2023 07:28:13 AM,11/01/2023 08:15:11 AM
2021/05/04,DPH Only,1621,327,1333,0,0,0,0,0,170700,97176,77108,0,0,0,0,0,11/01/2023 05:43:00 AM,11/01/2023 07:28:13 AM,11/01/2023 08:15:11 AM
2021/05/05,DPH Only,1606,307,1363,0,0,0,0,0,172306,97483,78471,0,0,0,0,0,11/01/2023 05:43:00 AM,11/01/2023 07:28:13 AM,11/01/2023 08:15:11 AM
2021/05/06,DPH Only,1554,400,1251,0,0,0,0,0,173860,97883,79722,0,0,0,0,0,11/01/2023 05:43:00 AM,11/01/2023 07:28:13 AM,11/01/2023 08:15:11 AM
2021/05/07,DPH Only,1873,396,1522,0,0,0,0,0,175733,98279,81244,0,0,0,0,0,11/01/2023 05:43:00 AM,11/01/2023 07:28:13 AM,11/01/2023 08:15:11 AM
2021/05/08,DPH Only,1491,256,1251,0,0,0,0,0,177224,98535,82495,0,0,0,0,0,11/01/2023 05:43:00 AM,11/01/2023 07:28:13 AM,11/01/2023 08:15:11 AM
2021/05/09,DPH Only,841,80,768,0,0,0,0,0,178065,98615,83263,0,0,0,0,0,11/01/2023 05:43:00 AM,11/01/2023 07:28:13 AM,11/01/2023 08:15:11 AM
2021/05/10,DPH Only,1154,221,965,0,0,0,0,0,179219,98836,84228,0,0,0,0,0,11/01/2023 05:43:00 AM,11/01/2023 07:28:13 AM,11/01/2023 08:15:11 AM
2021/05/11,DPH Only,1177,237,999,0,0,0,0,0,180396,99073,85227,0,0,0,0,0,11/01/2023 05:43:00 AM,11/01/2023 07:28:13 AM,11/01/2023 08:15:11 AM
2021/05/12,DPH Only,1114,251,922,0,0,0,0,0,181510,99324,86149,0,0,0,0,0,11/01/2023 05:43:00 AM,11/01/2023 07:28:13 AM,11/01/2023 08:15:11 AM
2021/05/13,DPH Only,1242,283,1006,0,0,0,0,0,182752,99607,87155,0,0,0,0,0,11/01/2023 05:43:00 AM,11/01/2023 07:28:13 AM,11/01/2023 08:15:11 AM
2021/05/14,DPH Only,1262,353,954,0,0,0,0,0,184014,99960,88109,0,0,0,0,0,11/01/2023 05:43:00 AM,11/01/2023 07:28:13 AM,11/01/2023 08:15:11 AM
2021/05/15,DPH Only,1158,459,714,0,0,0,0,0,185172,100419,88823,0,0,0,0,0,11/01/2023 05:43:00 AM,11/01/2023 07:28:13 AM,11/01/2023 08:15:11 AM
2021/05/16,DPH Only,172,60,116,0,0,0,0,0,185344,100479,88939,0,0,0,0,0,11/01/2023 05:43:00 AM,11/01/2023 07:28:13 AM,11/01/2023 08:15:11 AM
2021/05/17,DPH Only,972,352,658,0,0,0,0,0,186316,100831,89597,0,0,0,0,0,11/01/2023 05:43:00 AM,11/01/2023 07:28:13 AM,11/01/2023 08:15:11 AM
2021/05/18,DPH Only,857,335,599,0,0,0,0,0,187173,101166,90196,0,0,0,0,0,11/01/2023 05:43:00 AM,11/01/2023 07:28:13 AM,11/01/2023 08:15:11 AM
2021/05/19,DPH Only,703,293,503,0,0,0,0,0,187876,101459,90699,0,0,0,0,0,11/01/2023 05:43:00 AM,11/01/2023 07:28:13 AM,11/01/2023 08:15:11 AM
2021/05/20,DPH Only,832,285,626,0,0,0,0,0,188708,101744,91325,0,0,0,0,0,11/01/2023 05:43:00 AM,11/01/2023 07:28:13 AM,11/01/2023 08:15:11 AM
2021/05/21,DPH Only,817,362,519,0,0,0,0,0,189525,102106,91844,0,0,0,0,0,11/01/2023 05:43:00 AM,11/01/2023 07:28:13 AM,11/01/2023 08:15:11 AM
2021/05/22,DPH Only,826,358,488,0,0,0,0,0,190351,102464,92332,0,0,0,0,0,11/01/2023 05:43:00 AM,11/01/2023 07:28:13 AM,11/01/2023 08:15:11 AM
2021/05/23,DPH Only,92,26,70,0,0,0,0,0,190443,102490,92402,0,0,0,0,0,11/01/2023 05:43:00 AM,11/01/2023 07:28:13 AM,11/01/2023 08:15:11 AM
2021/05/24,DPH Only,617,257,393,0,0,0,0,0,191060,102747,92795,0,0,0,0,0,11/01/2023 05:43:00 AM,11/01/2023 07:28:13 AM,11/01/2023 08:15:11 AM
2021/05/25,DPH Only,613,255,430,0,0,0,0,0,191673,103002,93225,0,0,0,0,0,11/01/2023 05:43:00 AM,11/01/2023 07:28:13 AM,11/01/2023 08:15:11 AM
2021/05/26,DPH Only,510,196,353,0,0,0,0,0,192183,103198,93578,0,0,0,0,0,11/01/2023 05:43:00 AM,11/01/2023 07:28:13 AM,11/01/2023 08:15:11 AM
2021/05/27,DPH Only,611,227,443,0,0,0,0,0,192794,103425,94021,0,0,0,0,0,11/01/2023 05:43:00 AM,11/01/2023 07:28:13 AM,11/01/2023 08:15:11 AM
2021/05/28,DPH Only,636,253,420,0,0,0,0,0,193430,103678,94441,0,0,0,0,0,11/01/2023 05:43:00 AM,11/01/2023 07:28:13 AM,11/01/2023 08:15:11 AM
2021/05/29,DPH Only,640,309,342,0,0,0,0,0,194070,103987,94783,0,0,0,0,0,11/01/2023 05:43:00 AM,11/01/2023 07:28:13 AM,11/01/2023 08:15:11 AM
2021/05/30,DPH Only,64,21,44,0,0,0,0,0,194134,104008,94827,0,0,0,0,0,11/01/2023 05:43:00 AM,11/01/2023 07:28:13 AM,11/01/2023 08:15:11 AM
2021/05/31,DPH Only,7,4,4,0,0,0,0,0,194141,104012,94831,0,0,0,0,0,11/01/2023 05:43:00 AM,11/01/2023 07:28:13 AM,11/01/2023 08:15:11 AM
2021/06/01,DPH Only,682,248,498,0,0,0,0,0,194823,104260,95329,0,0,0,0,0,11/01/2023 05:43:00 AM,11/01/2023 07:28:13 AM,11/01/2023 08:15:11 AM
2021/06/02,DPH Only,395,164,277,0,0,0,0,0,195218,104424,95606,0,0,0,0,0,11/01/2023 05:43:00 AM,11/01/2023 07:28:13 AM,11/01/2023 08:15:11 AM
2021/06/03,DPH Only,571,236,395,0,0,0,0,0,195789,104660,96001,0,0,0,0,0,11/01/2023 05:43:00 AM,11/01/2023 07:28:13 AM,11/01/2023 08:15:11 AM
2021/06/04,DPH Only,711,276,495,0,0,0,0,0,196500,104936,96496,0,0,0,0,0,11/01/2023 05:43:00 AM,11/01/2023 07:28:13 AM,11/01/2023 08:15:11 AM
2021/06/05,DPH Only,712,252,481,0,0,0,0,0,197212,105188,96977,0,0,0,0,0,11/01/2023 05:43:00 AM,11/01/2023 07:28:13 AM,11/01/2023 08:15:11 AM
2021/06/06,DPH Only,86,26,62,0,0,0,0,0,197298,105214,97039,0,0,0,0,0,11/01/2023 05:43:00 AM,11/01/2023 07:28:13 AM,11/01/2023 08:15:11 AM
2021/06/07,DPH Only,572,220,383,0,0,0,0,0,197870,105434,97422,0,0,0,0,0,11/01/2023 05:43:00 AM,11/01/2023 07:28:13 AM,11/01/2023 08:15:11 AM
2021/06/08,DPH Only,440,209,300,0,0,0,0,0,198310,105643,97722,0,0,0,0,0,11/01/2023 05:43:00 AM,11/01/2023 07:28:13 AM,11/01/2023 08:15:11 AM
2021/06/09,DPH Only,411,205,283,0,0,0,0,0,198721,105848,98005,0,0,0,0,0,11/01/2023 05:43:00 AM,11/01/2023 07:28:13 AM,11/01/2023 08:15:11 AM
2021/06/10,DPH Only,396,186,247,0,0,0,0,0,199117,106034,98252,0,0,0,0,0,11/01/2023 05:43:00 AM,11/01/2023 07:28:13 AM,11/01/2023 08:15:11 AM
2021/06/11,DPH Only,469,200,312,0,0,0,0,0,199586,106234,98564,0,0,0,0,0,11/01/2023 05:43:00 AM,11/01/2023 07:28:13 AM,11/01/2023 08:15:11 AM
2021/06/12,DPH Only,487,158,341,0,0,0,0,0,200073,106392,98905,0,0,0,0,0,11/01/2023 05:43:00 AM,11/01/2023 07:28:13 AM,11/01/2023 08:15:11 AM
2021/06/13,DPH Only,36,15,22,0,0,0,0,0,200109,106407,98927,0,0,0,0,0,11/01/2023 05:43:00 AM,11/01/2023 07:28:13 AM,11/01/2023 08:15:11 AM
2021/06/14,DPH Only,355,160,226,0,0,0,0,0,200464,106567,99153,0,0,0,0,0,11/01/2023 05:43:00 AM,11/01/2023 07:28:13 AM,11/01/2023 08:15:11 AM
2021/06/15,DPH Only,385,167,269,0,0,0,0,0,200849,106734,99422,0,0,0,0,0,11/01/2023 05:43:00 AM,11/01/2023 07:28:13 AM,11/01/2023 08:15:11 AM
2021/06/16,DPH Only,341,174,229,0,0,0,0,0,201190,106908,99651,0,0,0,0,0,11/01/2023 05:43:00 AM,11/01/2023 07:28:13 AM,11/01/2023 08:15:11 AM
2021/06/17,DPH Only,324,156,218,0,0,0,0,0,201514,107064,99869,0,0,0,0,0,11/01/2023 05:43:00 AM,11/01/2023 07:28:13 AM,11/01/2023 08:15:11 AM
2021/06/18,DPH Only,473,164,351,0,0,0,0,0,201987,107228,100220,0,0,0,0,0,11/01/2023 05:43:00 AM,11/01/2023 07:28:13 AM,11/01/2023 08:15:11 AM
2021/06/19,DPH Only,251,109,160,0,0,0,0,0,202238,107337,100380,0,0,0,0,0,11/01/2023 05:43:00 AM,11/01/2023 07:28:13 AM,11/01/2023 08:15:11 AM
2021/06/20,DPH Only,46,25,24,0,0,0,0,0,202284,107362,100404,0,0,0,0,0,11/01/2023 05:43:00 AM,11/01/2023 07:28:13 AM,11/01/2023 08:15:11 AM
2021/06/21,DPH Only,206,126,107,0,0,0,0,0,202490,107488,100511,0,0,0,0,0,11/01/2023 05:43:00 AM,11/01/2023 07:28:13 AM,11/01/2023 08:15:11 AM
2021/06/22,DPH Only,327,145,244,0,0,0,0,0,202817,107633,100755,0,0,0,0,0,11/01/2023 05:43:00 AM,11/01/2023 07:28:13 AM,11/01/2023 08:15:11 AM
2021/06/23,DPH Only,271,142,174,0,0,0,0,0,203088,107775,100929,0,0,0,0,0,11/01/2023 05:43:00 AM,11/01/2023 07:28:13 AM,11/01/2023 08:15:11 AM
2021/06/24,DPH Only,318,138,229,0,0,0,0,0,203406,107913,101158,0,0,0,0,0,11/01/2023 05:43:00 AM,11/01/2023 07:28:13 AM,11/01/2023 08:15:11 AM
2021/06/25,DPH Only,418,169,285,0,0,0,0,0,203824,108082,101443,0,0,0,0,0,11/01/2023 05:43:00 AM,11/01/2023 07:28:13 AM,11/01/2023 08:15:11 AM
2021/06/26,DPH Only,230,121,151,0,0,0,0,0,204054,108203,101594,0,0,0,0,0,11/01/2023 05:43:00 AM,11/01/2023 07:28:13 AM,11/01/2023 08:15:11 AM
2021/06/27,DPH Only,32,10,24,0,0,0,0,0,204086,108213,101618,0,0,0,0,0,11/01/2023 05:43:00 AM,11/01/2023 07:28:13 AM,11/01/2023 08:15:11 AM
2021/06/28,DPH Only,321,97,248,0,0,0,0,0,204407,108310,101866,0,0,0,0,0,11/01/2023 05:43:00 AM,11/01/2023 07:28:13 AM,11/01/2023 08:15:11 AM
2021/06/29,DPH Only,271,125,200,0,0,0,0,0,204678,108435,102066,0,0,0,0,0,11/01/2023 05:43:00 AM,11/01/2023 07:28:13 AM,11/01/2023 08:15:11 AM
2021/06/30,DPH Only,233,97,159,0,0,0,0,0,204911,108532,102225,0,0,0,0,0,11/01/2023 05:43:00 AM,11/01/2023 07:28:13 AM,11/01/2023 08:15:11 AM
2021/07/01,DPH Only,290,132,198,0,0,0,0,0,205201,108664,102423,0,0,0,0,0,11/01/2023 05:43:00 AM,11/01/2023 07:28:13 AM,11/01/2023 08:15:11 AM
2021/07/02,DPH Only,354,186,234,0,0,0,0,0,205555,108850,102657,0,0,0,0,0,11/01/2023 05:43:00 AM,11/01/2023 07:28:13 AM,11/01/2023 08:15:11 AM
2021/07/03,DPH Only,154,95,102,0,0,0,0,0,205709,108945,102759,0,0,0,0,0,11/01/2023 05:43:00 AM,11/01/2023 07:28:13 AM,11/01/2023 08:15:11 AM
2021/07/04,DPH Only,3,3,0,0,0,0,0,0,205712,108948,102759,0,0,0,0,0,11/01/2023 05:43:00 AM,11/01/2023 07:28:13 AM,11/01/2023 08:15:11 AM
2021/07/05,DPH Only,12,6,6,0,0,0,0,0,205724,108954,102765,0,0,0,0,0,11/01/2023 05:43:00 AM,11/01/2023 07:28:13 AM,11/01/2023 08:15:11 AM
2021/07/06,DPH Only,348,121,265,0,0,0,0,0,206072,109075,103030,0,0,0,0,0,11/01/2023 05:43:00 AM,11/01/2023 07:28:13 AM,11/01/2023 08:15:11 AM
2021/07/07,DPH Only,242,110,165,0,0,0,0,0,206314,109185,103195,0,0,0,0,0,11/01/2023 05:43:00 AM,11/01/2023 07:28:13 AM,11/01/2023 08:15:11 AM
2021/07/08,DPH Only,239,132,177,0,0,0,0,0,206553,109317,103372,0,0,0,0,0,11/01/2023 05:43:00 AM,11/01/2023 07:28:13 AM,11/01/2023 08:15:11 AM
2021/07/09,DPH Only,293,162,189,0,0,0,0,0,206846,109479,103561,0,0,0,0,0,11/01/2023 05:43:00 AM,11/01/2023 07:28:13 AM,11/01/2023 08:15:11 AM
2021/07/10,DPH Only,110,64,79,0,0,0,0,0,206956,109543,103640,0,0,0,0,0,11/01/2023 05:43:00 AM,11/01/2023 07:28:13 AM,11/01/2023 08:15:11 AM
2021/07/11,DPH Only,6,3,3,0,0,0,0,0,206962,109546,103643,0,0,0,0,0,11/01/2023 05:43:00 AM,11/01/2023 07:28:13 AM,11/01/2023 08:15:11 AM
2021/07/12,DPH Only,275,131,177,0,0,0,0,0,207237,109677,103820,0,0,0,0,0,11/01/2023 05:43:00 AM,11/01/2023 07:28:13 AM,11/01/2023 08:15:11 AM
2021/07/13,DPH Only,189,104,123,0,0,0,0,0,207426,109781,103943,0,0,0,0,0,11/01/2023 05:43:00 AM,11/01/2023 07:28:13 AM,11/01/2023 08:15:11 AM
2021/07/14,DPH Only,220,130,137,0,0,0,0,0,207646,109911,104080,0,0,0,0,0,11/01/2023 05:43:00 AM,11/01/2023 07:28:13 AM,11/01/2023 08:15:11 AM
2021/07/15,DPH Only,203,99,124,0,0,0,0,0,207849,110010,104204,0,0,0,0,0,11/01/2023 05:43:00 AM,11/01/2023 07:28:13 AM,11/01/2023 08:15:11 AM
2021/07/16,DPH Only,261,135,156,0,0,0,0,0,208110,110145,104360,0,0,0,0,0,11/01/2023 05:43:00 AM,11/01/2023 07:28:13 AM,11/01/2023 08:15:11 AM
2021/07/17,DPH Only,121,70,71,0,0,0,0,0,208231,110215,104431,0,0,0,0,0,11/01/2023 05:43:00 AM,11/01/2023 07:28:13 AM,11/01/2023 08:15:11 AM
2021/07/18,DPH Only,7,3,6,0,0,0,0,0,208238,110218,104437,0,0,0,0,0,11/01/2023 05:43:00 AM,11/01/2023 07:28:13 AM,11/01/2023 08:15:11 AM
2021/07/19,DPH Only,256,143,139,0,0,0,0,0,208494,110361,104576,0,0,0,0,0,11/01/2023 05:43:00 AM,11/01/2023 07:28:13 AM,11/01/2023 08:15:11 AM
2021/07/20,DPH Only,199,135,109,0,0,0,0,0,208693,110496,104685,0,0,0,0,0,11/01/2023 05:43:00 AM,11/01/2023 07:28:13 AM,11/01/2023 08:15:11 AM
2021/07/21,DPH Only,217,144,104,0,0,0,0,0,208910,110640,104789,0,0,0,0,0,11/01/2023 05:43:00 AM,11/01/2023 07:28:13 AM,11/01/2023 08:15:11 AM
2021/07/22,DPH Only,255,166,129,0,0,0,0,0,209165,110806,104918,0,0,0,0,0,11/01/2023 05:43:00 AM,11/01/2023 07:28:13 AM,11/01/2023 08:15:11 AM
2021/07/23,DPH Only,259,158,145,0,0,0,0,0,209424,110964,105063,0,0,0,0,0,11/01/2023 05:43:00 AM,11/01/2023 07:28:13 AM,11/01/2023 08:15:11 AM
2021/07/24,DPH Only,111,70,55,0,0,0,0,0,209535,111034,105118,0,0,0,0,0,11/01/2023 05:43:00 AM,11/01/2023 07:28:13 AM,11/01/2023 08:15:11 AM
2021/07/25,DPH Only,11,7,7,0,0,0,0,0,209546,111041,105125,0,0,0,0,0,11/01/2023 05:43:00 AM,11/01/2023 07:28:13 AM,11/01/2023 08:15:11 AM
2021/07/26,DPH Only,176,145,58,0,0,0,0,0,209722,111186,105183,0,0,0,0,0,11/01/2023 05:43:00 AM,11/01/2023 07:28:13 AM,11/01/2023 08:15:11 AM
2021/07/27,DPH Only,226,157,95,0,0,0,0,0,209948,111343,105278,0,0,0,0,0,11/01/2023 05:43:00 AM,11/01/2023 07:28:13 AM,11/01/2023 08:15:11 AM
2021/07/28,DPH Only,223,144,124,0,0,0,0,0,210171,111487,105402,0,0,0,0,0,11/01/2023 05:43:00 AM,11/01/2023 07:28:13 AM,11/01/2023 08:15:11 AM
2021/07/29,DPH Only,255,174,117,0,0,0,0,0,210426,111661,105519,0,0,0,0,0,11/01/2023 05:43:00 AM,11/01/2023 07:28:13 AM,11/01/2023 08:15:11 AM
2021/07/30,DPH Only,267,170,124,0,0,0,0,0,210693,111831,105643,0,0,0,0,0,11/01/2023 05:43:00 AM,11/01/2023 07:28:13 AM,11/01/2023 08:15:11 AM
2021/07/31,DPH Only,114,84,43,0,0,0,0,0,210807,111915,105686,0,0,0,0,0,11/01/2023 05:43:00 AM,11/01/2023 07:28:13 AM,11/01/2023 08:15:11 AM
2021/08/01,DPH Only,9,6,4,0,0,0,0,0,210816,111921,105690,0,0,0,0,0,11/01/2023 05:43:00 AM,11/01/2023 07:28:13 AM,11/01/2023 08:15:11 AM
2021/08/02,DPH Only,261,161,131,0,0,0,0,0,211077,112082,105821,0,0,0,0,0,11/01/2023 05:43:00 AM,11/01/2023 07:28:13 AM,11/01/2023 08:15:11 AM
2021/08/03,DPH Only,217,137,117,0,0,0,0,0,211294,112219,105938,0,0,0,0,0,11/01/2023 05:43:00 AM,11/01/2023 07:28:13 AM,11/01/2023 08:15:11 AM
2021/08/04,DPH Only,234,160,110,0,0,0,0,0,211528,112379,106048,0,0,0,0,0,11/01/2023 05:43:00 AM,11/01/2023 07:28:13 AM,11/01/2023 08:15:11 AM
2021/08/05,DPH Only,231,166,101,0,0,0,0,0,211759,112545,106149,0,0,0,0,0,11/01/2023 05:43:00 AM,11/01/2023 07:28:13 AM,11/01/2023 08:15:11 AM
2021/08/06,DPH Only,261,171,120,127,127,0,0,0,212020,112716,106269,127,127,0,0,0,11/01/2023 05:43:00 AM,11/01/2023 07:28:13 AM,11/01/2023 08:15:11 AM
2021/08/07,DPH Only,113,78,39,147,147,0,0,0,212133,112794,106308,274,274,0,0,0,11/01/2023 05:43:00 AM,11/01/2023 07:28:13 AM,11/01/2023 08:15:11 AM
2021/08/08,DPH Only,2,2,0,0,0,0,0,0,212135,112796,106308,274,274,0,0,0,11/01/2023 05:43:00 AM,11/01/2023 07:28:13 AM,11/01/2023 08:15:11 AM
2021/08/09,DPH Only,259,151,129,168,168,0,0,0,212394,112947,106437,442,442,0,0,0,11/01/2023 05:43:00 AM,11/01/2023 07:28:13 AM,11/01/2023 08:15:11 AM
2021/08/10,DPH Only,213,129,112,103,103,0,0,0,212607,113076,106549,545,545,0,0,0,11/01/2023 05:43:00 AM,11/01/2023 07:28:13 AM,11/01/2023 08:15:11 AM
2021/08/11,DPH Only,254,151,122,90,90,0,0,0,212861,113227,106671,635,635,0,0,0,11/01/2023 05:43:00 AM,11/01/2023 07:28:13 AM,11/01/2023 08:15:11 AM
2021/08/12,DPH Only,294,194,134,111,111,0,0,0,213155,113421,106805,746,746,0,0,0,11/01/2023 05:43:00 AM,11/01/2023 07:28:13 AM,11/01/2023 08:15:11 AM
2021/08/13,DPH Only,300,176,140,144,144,0,0,0,213455,113597,106945,890,890,0,0,0,11/01/2023 05:43:00 AM,11/01/2023 07:28:13 AM,11/01/2023 08:15:11 AM
2021/08/14,DPH Only,174,122,63,59,59,0,0,0,213629,113719,107008,949,949,0,0,0,11/01/2023 05:43:00 AM,11/01/2023 07:28:13 AM,11/01/2023 08:15:11 AM
2021/08/15,DPH Only,27,26,7,0,0,0,0,0,213656,113745,107015,949,949,0,0,0,11/01/2023 05:43:00 AM,11/01/2023 07:28:13 AM,11/01/2023 08:15:11 AM
2021/08/16,DPH Only,247,139,126,98,98,0,0,0,213903,113884,107141,1047,1047,0,0,0,11/01/2023 05:43:00 AM,11/01/2023 07:28:13 AM,11/01/2023 08:15:11 AM
2021/08/17,DPH Only,236,118,145,85,85,0,0,0,214139,114002,107286,1132,1132,0,0,0,11/01/2023 05:43:00 AM,11/01/2023 07:28:13 AM,11/01/2023 08:15:11 AM
2021/08/18,DPH Only,189,122,91,94,94,0,0,0,214328,114124,107377,1226,1226,0,0,0,11/01/2023 05:43:00 AM,11/01/2023 07:28:13 AM,11/01/2023 08:15:11 AM
2021/08/19,DPH Only,252,143,139,101,101,0,0,0,214580,114267,107516,1327,1327,0,0,0,11/01/2023 05:43:00 AM,11/01/2023 07:28:13 AM,11/01/2023 08:15:11 AM
2021/08/20,DPH Only,321,200,142,112,112,0,0,0,214901,114467,107658,1439,1439,0,0,0,11/01/2023 05:43:00 AM,11/01/2023 07:28:13 AM,11/01/2023 08:15:11 AM
2021/08/21,DPH Only,218,135,95,39,39,0,0,0,215119,114602,107753,1478,1478,0,0,0,11/01/2023 05:43:00 AM,11/01/2023 07:28:13 AM,11/01/2023 08:15:11 AM
2021/08/22,DPH Only,14,12,3,1,1,0,0,0,215133,114614,107756,1479,1479,0,0,0,11/01/2023 05:43:00 AM,11/01/2023 07:28:13 AM,11/01/2023 08:15:11 AM
2021/08/23,DPH Only,233,127,128,84,84,0,0,0,215366,114741,107884,1563,1563,0,0,0,11/01/2023 05:43:00 AM,11/01/2023 07:28:13 AM,11/01/2023 08:15:11 AM
2021/08/24,DPH Only,245,142,139,74,74,0,0,0,215611,114883,108023,1637,1637,0,0,0,11/01/2023 05:43:00 AM,11/01/2023 07:28:13 AM,11/01/2023 08:15:11 AM
2021/08/25,DPH Only,204,104,123,66,66,0,0,0,215815,114987,108146,1703,1703,0,0,0,11/01/2023 05:43:00 AM,11/01/2023 07:28:13 AM,11/01/2023 08:15:11 AM
2021/08/26,DPH Only,292,184,142,92,91,0,0,0,216107,115171,108288,1795,1794,0,0,0,11/01/2023 05:43:00 AM,11/01/2023 07:28:13 AM,11/01/2023 08:15:11 AM
2021/08/27,DPH Only,267,148,134,88,88,0,0,0,216374,115319,108422,1883,1882,0,0,0,11/01/2023 05:43:00 AM,11/01/2023 07:28:13 AM,11/01/2023 08:15:11 AM
2021/08/28,DPH Only,210,115,113,33,33,0,0,0,216584,115434,108535,1916,1915,0,0,0,11/01/2023 05:43:00 AM,11/01/2023 07:28:13 AM,11/01/2023 08:15:11 AM
2021/08/29,DPH Only,5,2,4,0,0,0,0,0,216589,115436,108539,1916,1915,0,0,0,11/01/2023 05:43:00 AM,11/01/2023 07:28:13 AM,11/01/2023 08:15:11 AM
2021/08/30,DPH Only,229,106,139,82,81,0,0,0,216818,115542,108678,1998,1996,0,0,0,11/01/2023 05:43:00 AM,11/01/2023 07:28:13 AM,11/01/2023 08:15:11 AM
2021/08/31,DPH Only,201,107,117,73,73,0,0,0,217019,115649,108795,2071,2069,0,0,0,11/01/2023 05:43:00 AM,11/01/2023 07:28:13 AM,11/01/2023 08:15:11 AM
2021/09/01,DPH Only,219,107,126,71,71,0,0,0,217238,115756,108921,2142,2140,0,0,0,11/01/2023 05:43:00 AM,11/01/2023 07:28:13 AM,11/01/2023 08:15:11 AM
2021/09/02,DPH Only,229,96,156,68,68,0,0,0,217467,115852,109077,2210,2208,0,0,0,11/01/2023 05:43:00 AM,11/01/2023 07:28:13 AM,11/01/2023 08:15:11 AM
2021/09/03,DPH Only,258,125,158,65,64,0,0,0,217725,115977,109235,2275,2272,0,0,0,11/01/2023 05:43:00 AM,11/01/2023 07:28:13 AM,11/01/2023 08:15:11 AM
2021/09/04,DPH Only,194,103,116,22,22,0,0,0,217919,116080,109351,2297,2294,0,0,0,11/01/2023 05:43:00 AM,11/01/2023 07:28:13 AM,11/01/2023 08:15:11 AM
2021/09/05,DPH Only,4,3,1,0,0,0,0,0,217923,116083,109352,2297,2294,0,0,0,11/01/2023 05:43:00 AM,11/01/2023 07:28:13 AM,11/01/2023 08:15:11 AM
2021/09/06,DPH Only,8,5,3,1,1,0,0,0,217931,116088,109355,2298,2295,0,0,0,11/01/2023 05:43:00 AM,11/01/2023 07:28:13 AM,11/01/2023 08:15:11 AM
2021/09/07,DPH Only,225,89,153,63,63,0,0,0,218156,116177,109508,2361,2358,0,0,0,11/01/2023 05:43:00 AM,11/01/2023 07:28:13 AM,11/01/2023 08:15:11 AM
2021/09/08,DPH Only,170,82,102,56,56,0,0,0,218326,116259,109610,2417,2414,0,0,0,11/01/2023 05:43:00 AM,11/01/2023 07:28:13 AM,11/01/2023 08:15:11 AM
2021/09/09,DPH Only,255,135,152,55,55,0,0,0,218581,116394,109762,2472,2469,0,0,0,11/01/2023 05:43:00 AM,11/01/2023 07:28:13 AM,11/01/2023 08:15:11 AM
2021/09/10,DPH Only,284,109,193,37,37,0,0,0,218865,116503,109955,2509,2506,0,0,0,11/01/2023 05:43:00 AM,11/01/2023 07:28:13 AM,11/01/2023 08:15:11 AM
2021/09/11,DPH Only,146,73,83,17,16,1,0,0,219011,116576,110038,2526,2522,1,0,0,11/01/2023 05:43:00 AM,11/01/2023 07:28:13 AM,11/01/2023 08:15:11 AM
2021/09/12,DPH Only,12,9,3,1,1,0,0,0,219023,116585,110041,2527,2523,1,0,0,11/01/2023 05:43:00 AM,11/01/2023 07:28:13 AM,11/01/2023 08:15:11 AM
2021/09/13,DPH Only,181,68,120,57,55,2,0,0,219204,116653,110161,2584,2578,3,0,0,11/01/2023 05:43:00 AM,11/01/2023 07:28:13 AM,11/01/2023 08:15:11 AM
2021/09/14,DPH Only,182,84,127,69,68,1,0,0,219386,116737,110288,2653,2646,4,0,0,11/01/2023 05:43:00 AM,11/01/2023 07:28:13 AM,11/01/2023 08:15:11 AM
2021/09/15,DPH Only,176,90,113,58,58,0,0,0,219562,116827,110401,2711,2704,4,0,0,11/01/2023 05:43:00 AM,11/01/2023 07:28:13 AM,11/01/2023 08:15:11 AM
2021/09/16,DPH Only,196,86,136,58,58,0,0,0,219758,116913,110537,2769,2762,4,0,0,11/01/2023 05:43:00 AM,11/01/2023 07:28:13 AM,11/01/2023 08:15:11 AM
2021/09/17,DPH Only,220,79,161,52,52,0,0,0,219978,116992,110698,2821,2814,4,0,0,11/01/2023 05:43:00 AM,11/01/2023 07:28:13 AM,11/01/2023 08:15:11 AM
2021/09/18,DPH Only,163,69,115,19,19,0,0,0,220141,117061,110813,2840,2833,4,0,0,11/01/2023 05:43:00 AM,11/01/2023 07:28:13 AM,11/01/2023 08:15:11 AM
2021/09/19,DPH Only,8,3,5,0,0,0,0,0,220149,117064,110818,2840,2833,4,0,0,11/01/2023 05:43:00 AM,11/01/2023 07:28:13 AM,11/01/2023 08:15:11 AM
2021/09/20,DPH Only,160,82,96,52,52,0,0,0,220309,117146,110914,2892,2885,4,0,0,11/01/2023 05:43:00 AM,11/01/2023 07:28:13 AM,11/01/2023 08:15:11 AM
2021/09/21,DPH Only,135,72,86,48,46,2,0,0,220444,117218,111000,2940,2931,6,0,0,11/01/2023 05:43:00 AM,11/01/2023 07:28:13 AM,11/01/2023 08:15:11 AM
2021/09/22,DPH Only,131,64,75,43,43,0,0,0,220575,117282,111075,2983,2974,6,0,0,11/01/2023 05:43:00 AM,11/01/2023 07:28:13 AM,11/01/2023 08:15:11 AM
2021/09/23,DPH Only,164,81,108,47,47,0,0,0,220739,117363,111183,3030,3021,6,0,0,11/01/2023 05:43:00 AM,11/01/2023 07:28:13 AM,11/01/2023 08:15:11 AM
2021/09/24,DPH Only,192,101,117,51,51,1,0,0,220931,117464,111300,3081,3072,7,0,0,11/01/2023 05:43:00 AM,11/01/2023 07:28:13 AM,11/01/2023 08:15:11 AM
2021/09/25,DPH Only,150,58,107,30,30,0,0,0,221081,117522,111407,3111,3102,7,0,0,11/01/2023 05:43:00 AM,11/01/2023 07:28:13 AM,11/01/2023 08:15:11 AM
2021/09/26,DPH Only,10,9,6,7,7,0,0,0,221091,117531,111413,3118,3109,7,0,0,11/01/2023 05:43:00 AM,11/01/2023 07:28:13 AM,11/01/2023 08:15:11 AM
2021/09/27,DPH Only,124,82,68,62,62,0,0,0,221215,117613,111481,3180,3171,7,0,0,11/01/2023 05:43:00 AM,11/01/2023 07:28:13 AM,11/01/2023 08:15:11 AM
2021/09/28,DPH Only,144,76,94,73,73,0,0,0,221359,117689,111575,3253,3244,7,0,0,11/01/2023 05:43:00 AM,11/01/2023 07:28:13 AM,11/01/2023 08:15:11 AM
2021/09/29,DPH Only,176,97,118,109,108,1,0,0,221535,117786,111693,3362,3352,8,0,0,11/01/2023 05:43:00 AM,11/01/2023 07:28:13 AM,11/01/2023 08:15:11 AM
2021/09/30,DPH Only,164,88,98,116,116,0,0,0,221699,117874,111791,3478,3468,8,0,0,11/01/2023 05:43:00 AM,11/01/2023 07:28:13 AM,11/01/2023 08:15:11 AM
2021/10/01,DPH Only,205,89,134,150,149,2,0,0,221904,117963,111925,3628,3617,10,0,0,11/01/2023 05:43:00 AM,11/01/2023 07:28:13 AM,11/01/2023 08:15:11 AM
2021/10/02,DPH Only,65,31,40,23,22,1,0,0,221969,117994,111965,3651,3639,11,0,0,11/01/2023 05:43:00 AM,11/01/2023 07:28:13 AM,11/01/2023 08:15:11 AM
2021/10/03,DPH Only,8,3,5,4,4,0,0,0,221977,117997,111970,3655,3643,11,0,0,11/01/2023 05:43:00 AM,11/01/2023 07:28:13 AM,11/01/2023 08:15:11 AM
2021/10/04,DPH Only,115,69,60,282,282,0,0,0,222092,118066,112030,3937,3925,11,0,0,11/01/2023 05:43:00 AM,11/01/2023 07:28:13 AM,11/01/2023 08:15:11 AM
2021/10/05,DPH Only,140,78,80,270,269,1,0,0,222232,118144,112110,4207,4194,12,0,0,11/01/2023 05:43:00 AM,11/01/2023 07:28:13 AM,11/01/2023 08:15:11 AM
2021/10/06,DPH Only,99,45,64,241,241,0,0,0,222331,118189,112174,4448,4435,12,0,0,11/01/2023 05:43:00 AM,11/01/2023 07:28:13 AM,11/01/2023 08:15:11 AM
2021/10/07,DPH Only,133,63,88,251,250,1,0,0,222464,118252,112262,4699,4685,13,0,0,11/01/2023 05:43:00 AM,11/01/2023 07:28:13 AM,11/01/2023 08:15:11 AM
2021/10/08,DPH Only,129,71,80,277,276,0,0,0,222593,118323,112342,4976,4961,13,0,0,11/01/2023 05:43:00 AM,11/01/2023 07:28:13 AM,11/01/2023 08:15:11 AM
2021/10/09,DPH Only,59,40,27,78,78,0,0,0,222652,118363,112369,5054,5039,13,0,0,11/01/2023 05:43:00 AM,11/01/2023 07:28:13 AM,11/01/2023 08:15:11 AM
2021/10/10,DPH Only,6,2,4,4,4,0,0,0,222658,118365,112373,5058,5043,13,0,0,11/01/2023 05:43:00 AM,11/01/2023 07:28:13 AM,11/01/2023 08:15:11 AM
2021/10/11,DPH Only,48,25,27,75,75,0,0,0,222706,118390,112400,5133,5118,13,0,0,11/01/2023 05:43:00 AM,11/01/2023 07:28:13 AM,11/01/2023 08:15:11 AM
2021/10/12,DPH Only,112,51,76,208,208,0,0,0,222818,118441,112476,5341,5326,13,0,0,11/01/2023 05:43:00 AM,11/01/2023 07:28:13 AM,11/01/2023 08:15:11 AM
2021/10/13,DPH Only,107,61,64,270,270,0,0,0,222925,118502,112540,5611,5596,13,0,0,11/01/2023 05:43:00 AM,11/01/2023 07:28:13 AM,11/01/2023 08:15:11 AM
2021/10/14,DPH Only,124,71,80,274,274,1,0,0,223049,118573,112620,5885,5870,14,0,0,11/01/2023 05:43:00 AM,11/01/2023 07:28:13 AM,11/01/2023 08:15:11 AM
2021/10/15,DPH Only,138,70,86,335,334,0,0,0,223187,118643,112706,6220,6204,14,0,0,11/01/2023 05:43:00 AM,11/01/2023 07:28:13 AM,11/01/2023 08:15:11 AM
2021/10/16,DPH Only,46,30,29,107,107,0,0,0,223233,118673,112735,6327,6311,14,0,0,11/01/2023 05:43:00 AM,11/01/2023 07:28:13 AM,11/01/2023 08:15:11 AM
2021/10/17,DPH Only,4,2,2,1,1,0,0,0,223237,118675,112737,6328,6312,14,0,0,11/01/2023 05:43:00 AM,11/01/2023 07:28:13 AM,11/01/2023 08:15:11 AM
2021/10/18,DPH Only,143,78,97,288,288,0,0,0,223380,118753,112834,6616,6600,14,0,0,11/01/2023 05:43:00 AM,11/01/2023 07:28:13 AM,11/01/2023 08:15:11 AM
2021/10/19,DPH Only,93,51,57,272,272,0,0,0,223473,118804,112891,6888,6872,14,0,0,11/01/2023 05:43:00 AM,11/01/2023 07:28:13 AM,11/01/2023 08:15:11 AM
2021/10/20,DPH Only,90,36,58,281,281,0,0,0,223563,118840,112949,7169,7153,14,0,0,11/01/2023 05:43:00 AM,11/01/2023 07:28:13 AM,11/01/2023 08:15:11 AM
2021/10/21,DPH Only,139,83,91,298,298,0,0,0,223702,118923,113040,7467,7451,14,0,0,11/01/2023 05:43:00 AM,11/01/2023 07:28:13 AM,11/01/2023 08:15:11 AM
2021/10/22,DPH Only,115,55,71,321,321,0,0,0,223817,118978,113111,7788,7772,14,0,0,11/01/2023 05:43:00 AM,11/01/2023 07:28:13 AM,11/01/2023 08:15:11 AM
2021/10/23,DPH Only,44,27,26,79,79,0,0,0,223861,119005,113137,7867,7851,14,0,0,11/01/2023 05:43:00 AM,11/01/2023 07:28:13 AM,11/01/2023 08:15:11 AM
2021/10/24,DPH Only,4,2,2,1,1,0,0,0,223865,119007,113139,7868,7852,14,0,0,11/01/2023 05:43:00 AM,11/01/2023 07:28:13 AM,11/01/2023 08:15:11 AM
2021/10/25,DPH Only,100,47,66,311,311,1,0,0,223965,119054,113205,8179,8163,15,0,0,11/01/2023 05:43:00 AM,11/01/2023 07:28:13 AM,11/01/2023 08:15:11 AM
2021/10/26,DPH Only,109,55,78,321,321,1,0,0,224074,119109,113283,8500,8484,16,0,0,11/01/2023 05:43:00 AM,11/01/2023 07:28:13 AM,11/01/2023 08:15:11 AM
2021/10/27,DPH Only,80,46,45,512,512,0,0,0,224154,119155,113328,9012,8996,16,0,0,11/01/2023 05:43:00 AM,11/01/2023 07:28:13 AM,11/01/2023 08:15:11 AM
2021/10/28,DPH Only,118,74,70,700,699,0,0,0,224272,119229,113398,9712,9695,16,0,0,11/01/2023 05:43:00 AM,11/01/2023 07:28:13 AM,11/01/2023 08:15:11 AM
2021/10/29,DPH Only,125,78,85,873,873,0,0,0,224397,119307,113483,10585,10568,16,0,0,11/01/2023 05:43:00 AM,11/01/2023 07:28:13 AM,11/01/2023 08:15:11 AM
2021/10/30,DPH Only,61,25,47,220,220,1,0,0,224458,119332,113530,10805,10788,17,0,0,11/01/2023 05:43:00 AM,11/01/2023 07:28:13 AM,11/01/2023 08:15:11 AM
2021/10/31,DPH Only,4,2,2,0,0,0,0,0,224462,119334,113532,10805,10788,17,0,0,11/01/2023 05:43:00 AM,11/01/2023 07:28:13 AM,11/01/2023 08:15:11 AM
2021/11/01,DPH Only,89,54,53,754,753,1,0,0,224551,119388,113585,11559,11541,18,0,0,11/01/2023 05:43:00 AM,11/01/2023 07:28:13 AM,11/01/2023 08:15:11 AM
2021/11/02,DPH Only,104,68,52,704,704,2,0,0,224655,119456,113637,12263,12245,20,0,0,11/01/2023 05:43:00 AM,11/01/2023 07:28:13 AM,11/01/2023 08:15:11 AM
2021/11/03,DPH Only,84,53,47,609,609,1,0,0,224739,119509,113684,12872,12854,21,0,0,11/01/2023 05:43:00 AM,11/01/2023 07:28:13 AM,11/01/2023 08:15:11 AM
2021/11/04,DPH Only,109,74,60,684,684,0,0,0,224848,119583,113744,13556,13538,21,0,0,11/01/2023 05:43:00 AM,11/01/2023 07:28:13 AM,11/01/2023 08:15:11 AM
2021/11/05,DPH Only,221,170,75,875,874,2,0,0,225069,119753,113819,14431,14412,23,0,0,11/01/2023 05:43:00 AM,11/01/2023 07:28:13 AM,11/01/2023 08:15:11 AM
2021/11/06,DPH Only,308,289,22,231,231,0,0,0,225377,120042,113841,14662,14643,23,0,0,11/01/2023 05:43:00 AM,11/01/2023 07:28:13 AM,11/01/2023 08:15:11 AM
2021/11/07,DPH Only,6,5,2,6,6,0,0,0,225383,120047,113843,14668,14649,23,0,0,11/01/2023 05:43:00 AM,11/01/2023 07:28:13 AM,11/01/2023 08:15:11 AM
2021/11/08,DPH Only,223,194,45,708,708,2,0,0,225606,120241,113888,15376,15357,25,0,0,11/01/2023 05:43:00 AM,11/01/2023 07:28:13 AM,11/01/2023 08:15:11 AM
2021/11/09,DPH Only,162,132,53,639,639,1,0,0,225768,120373,113941,16015,15996,26,0,0,11/01/2023 05:43:00 AM,11/01/2023 07:28:13 AM,11/01/2023 08:15:11 AM
2021/11/10,DPH Only,181,148,41,787,787,1,0,0,225949,120521,113982,16802,16783,27,0,0,11/01/2023 05:43:00 AM,11/01/2023 07:28:13 AM,11/01/2023 08:15:11 AM
2021/11/11,DPH Only,197,187,24,350,350,0,0,0,226146,120708,114006,17152,17133,27,0,0,11/01/2023 05:43:00 AM,11/01/2023 07:28:13 AM,11/01/2023 08:15:11 AM
2021/11/12,DPH Only,264,220,64,1026,1025,2,0,0,226410,120928,114070,18178,18158,29,0,0,11/01/2023 05:43:00 AM,11/01/2023 07:28:13 AM,11/01/2023 08:15:11 AM
2021/11/13,DPH Only,278,259,31,562,562,1,0,0,226688,121187,114101,18740,18720,30,0,0,11/01/2023 05:43:00 AM,11/01/2023 07:28:13 AM,11/01/2023 08:15:11 AM
2021/11/14,DPH Only,3,1,3,4,4,0,0,0,226691,121188,114104,18744,18724,30,0,0,11/01/2023 05:43:00 AM,11/01/2023 07:28:13 AM,11/01/2023 08:15:11 AM
2021/11/15,DPH Only,150,116,51,831,830,1,0,0,226841,121304,114155,19575,19554,31,0,0,11/01/2023 05:43:00 AM,11/01/2023 07:28:13 AM,11/01/2023 08:15:11 AM
2021/11/16,DPH Only,111,80,46,813,812,1,0,0,226952,121384,114201,20388,20366,32,0,0,11/01/2023 05:43:00 AM,11/01/2023 07:28:13 AM,11/01/2023 08:15:11 AM
2021/11/17,DPH Only,125,98,44,815,814,4,0,0,227077,121482,114245,21203,21180,36,0,0,11/01/2023 05:43:00 AM,11/01/2023 07:28:13 AM,11/01/2023 08:15:11 AM
2021/11/18,DPH Only,136,102,48,892,892,2,0,0,227213,121584,114293,22095,22072,38,0,0,11/01/2023 05:43:00 AM,11/01/2023 07:28:13 AM,11/01/2023 08:15:11 AM
2021/11/19,DPH Only,242,212,63,1254,1252,2,0,0,227455,121796,114356,23349,23324,40,0,0,11/01/2023 05:43:00 AM,11/01/2023 07:28:13 AM,11/01/2023 08:15:11 AM
2021/11/20,DPH Only,158,142,25,567,567,1,0,0,227613,121938,114381,23916,23891,41,0,0,11/01/2023 05:43:00 AM,11/01/2023 07:28:13 AM,11/01/2023 08:15:11 AM
2021/11/21,DPH Only,4,3,1,3,3,0,0,0,227617,121941,114382,23919,23894,41,0,0,11/01/2023 05:43:00 AM,11/01/2023 07:28:13 AM,11/01/2023 08:15:11 AM
2021/11/22,DPH Only,206,183,37,952,952,4,0,0,227823,122124,114419,24871,24846,45,0,0,11/01/2023 05:43:00 AM,11/01/2023 07:28:13 AM,11/01/2023 08:15:11 AM
2021/11/23,DPH Only,186,147,60,876,875,3,0,0,228009,122271,114479,25747,25721,48,0,0,11/01/2023 05:43:00 AM,11/01/2023 07:28:13 AM,11/01/2023 08:15:11 AM
2021/11/24,DPH Only,153,121,45,684,684,1,0,0,228162,122392,114524,26431,26405,49,0,0,11/01/2023 05:43:00 AM,11/01/2023 07:28:13 AM,11/01/2023 08:15:11 AM
2021/11/25,DPH Only,6,2,4,2,2,0,0,0,228168,122394,114528,26433,26407,49,0,0,11/01/2023 05:43:00 AM,11/01/2023 07:28:13 AM,11/01/2023 08:15:11 AM
2021/11/26,DPH Only,4,1,3,5,5,0,0,0,228172,122395,114531,26438,26412,49,0,0,11/01/2023 05:43:00 AM,11/01/2023 07:28:13 AM,11/01/2023 08:15:11 AM
2021/11/27,DPH Only,159,91,75,307,306,0,0,0,228331,122486,114606,26745,26718,49,0,0,11/01/2023 05:43:00 AM,11/01/2023 07:28:13 AM,11/01/2023 08:15:11 AM
2021/11/28,DPH Only,6,1,5,2,2,0,0,0,228337,122487,114611,26747,26720,49,0,0,11/01/2023 05:43:00 AM,11/01/2023 07:28:13 AM,11/01/2023 08:15:11 AM
2021/11/29,DPH Only,288,116,190,909,909,2,0,0,228625,122603,114801,27656,27629,51,0,0,11/01/2023 05:43:00 AM,11/01/2023 07:28:13 AM,11/01/2023 08:15:11 AM
2021/11/30,DPH Only,213,111,127,968,967,6,0,0,228838,122714,114928,28624,28596,57,0,0,11/01/2023 05:43:00 AM,11/01/2023 07:28:13 AM,11/01/2023 08:15:11 AM
2021/12/01,DPH Only,247,140,136,1049,1046,3,0,0,229085,122854,115064,29673,29642,60,0,0,11/01/2023 05:43:00 AM,11/01/2023 07:28:13 AM,11/01/2023 08:15:11 AM
2021/12/02,DPH Only,303,163,175,1261,1261,1,0,0,229388,123017,115239,30934,30903,61,0,0,11/01/2023 05:43:00 AM,11/01/2023 07:28:13 AM,11/01/2023 08:15:11 AM
2021/12/03,DPH Only,393,198,228,1348,1346,4,0,0,229781,123215,115467,32282,32249,65,0,0,11/01/2023 05:43:00 AM,11/01/2023 07:28:13 AM,11/01/2023 08:15:11 AM
2021/12/04,DPH Only,263,97,177,485,484,1,0,0,230044,123312,115644,32767,32733,66,0,0,11/01/2023 05:43:00 AM,11/01/2023 07:28:13 AM,11/01/2023 08:15:11 AM
2021/12/05,DPH Only,1,0,1,4,4,0,0,0,230045,123312,115645,32771,32737,66,0,0,11/01/2023 05:43:00 AM,11/01/2023 07:28:13 AM,11/01/2023 08:15:11 AM
2021/12/06,DPH Only,254,102,170,1020,1020,2,0,0,230299,123414,115815,33791,33757,68,0,0,11/01/2023 05:43:00 AM,11/01/2023 07:28:13 AM,11/01/2023 08:15:11 AM
2021/12/07,DPH Only,166,104,78,914,913,1,0,0,230465,123518,115893,34705,34670,69,0,0,11/01/2023 05:43:00 AM,11/01/2023 07:28:13 AM,11/01/2023 08:15:11 AM
2021/12/08,DPH Only,217,139,105,971,971,0,0,0,230682,123657,115998,35676,35641,69,0,0,11/01/2023 05:43:00 AM,11/01/2023 07:28:13 AM,11/01/2023 08:15:11 AM
2021/12/09,DPH Only,210,150,85,1129,1125,6,0,0,230892,123807,116083,36805,36766,75,0,0,11/01/2023 05:43:00 AM,11/01/2023 07:28:13 AM,11/01/2023 08:15:11 AM
2021/12/10,DPH Only,314,171,173,1246,1246,2,0,0,231206,123978,116256,38051,38012,77,0,0,11/01/2023 05:43:00 AM,11/01/2023 07:28:13 AM,11/01/2023 08:15:11 AM
2021/12/11,DPH Only,260,125,151,458,458,0,0,0,231466,124103,116407,38509,38470,77,0,0,11/01/2023 05:43:00 AM,11/01/2023 07:28:13 AM,11/01/2023 08:15:11 AM
2021/12/12,DPH Only,8,4,5,10,10,0,0,0,231474,124107,116412,38519,38480,77,0,0,11/01/2023 05:43:00 AM,11/01/2023 07:28:13 AM,11/01/2023 08:15:11 AM
2021/12/13,DPH Only,243,129,139,906,905,4,0,0,231717,124236,116551,39425,39385,81,0,0,11/01/2023 05:43:00 AM,11/01/2023 07:28:13 AM,11/01/2023 08:15:11 AM
2021/12/14,DPH Only,152,73,92,735,733,3,0,0,231869,124309,116643,40160,40118,84,0,0,11/01/2023 05:43:00 AM,11/01/2023 07:28:13 AM,11/01/2023 08:15:11 AM
2021/12/15,DPH Only,161,77,102,695,694,2,0,0,232030,124386,116745,40855,40812,86,0,0,11/01/2023 05:43:00 AM,11/01/2023 07:28:13 AM,11/01/2023 08:15:11 AM
2021/12/16,DPH Only,168,113,83,940,940,1,0,0,232198,124499,116828,41795,41752,87,0,0,11/01/2023 05:43:00 AM,11/01/2023 07:28:13 AM,11/01/2023 08:15:11 AM
2021/12/17,DPH Only,210,143,93,1199,1195,6,0,0,232408,124642,116921,42994,42947,93,0,0,11/01/2023 05:43:00 AM,11/01/2023 07:28:13 AM,11/01/2023 08:15:11 AM
2021/12/18,DPH Only,227,121,120,599,597,3,0,0,232635,124763,117041,43593,43544,96,0,0,11/01/2023 05:43:00 AM,11/01/2023 07:28:13 AM,11/01/2023 08:15:11 AM
2021/12/19,DPH Only,1,0,1,5,5,1,0,0,232636,124763,117042,43598,43549,97,0,0,11/01/2023 05:43:00 AM,11/01/2023 07:28:13 AM,11/01/2023 08:15:11 AM
2021/12/20,DPH Only,202,120,98,992,989,7,0,0,232838,124883,117140,44590,44538,104,0,0,11/01/2023 05:43:00 AM,11/01/2023 07:28:13 AM,11/01/2023 08:15:11 AM
2021/12/21,DPH Only,205,137,94,1028,1026,3,0,0,233043,125020,117234,45618,45564,107,0,0,11/01/2023 05:43:00 AM,11/01/2023 07:28:13 AM,11/01/2023 08:15:11 AM
2021/12/22,DPH Only,180,96,97,898,897,1,0,0,233223,125116,117331,46516,46461,108,0,0,11/01/2023 05:43:00 AM,11/01/2023 07:28:13 AM,11/01/2023 08:15:11 AM
2021/12/23,DPH Only,158,100,74,884,882,5,0,0,233381,125216,117405,47400,47343,113,0,0,11/01/2023 05:43:00 AM,11/01/2023 07:28:13 AM,11/01/2023 08:15:11 AM
2021/12/24,DPH Only,104,58,58,610,610,0,0,0,233485,125274,117463,48010,47953,113,0,0,11/01/2023 05:43:00 AM,11/01/2023 07:28:13 AM,11/01/2023 08:15:11 AM
2021/12/25,DPH Only,3,0,3,2,2,0,0,0,233488,125274,117466,48012,47955,113,0,0,11/01/2023 05:43:00 AM,11/01/2023 07:28:13 AM,11/01/2023 08:15:11 AM
2021/12/26,DPH Only,0,0,0,2,2,0,0,0,233488,125274,117466,48014,47957,113,0,0,11/01/2023 05:43:00 AM,11/01/2023 07:28:13 AM,11/01/2023 08:15:11 AM
2021/12/27,DPH Only,300,162,160,868,868,1,0,0,233788,125436,117626,48882,48825,114,0,0,11/01/2023 05:43:00 AM,11/01/2023 07:28:13 AM,11/01/2023 08:15:11 AM
2021/12/28,DPH Only,176,113,74,829,827,2,0,0,233964,125549,117700,49711,49652,116,0,0,11/01/2023 05:43:00 AM,11/01/2023 07:28:13 AM,11/01/2023 08:15:11 AM
2021/12/29,DPH Only,189,123,81,759,757,2,0,0,234153,125672,117781,50470,50409,118,0,0,11/01/2023 05:43:00 AM,11/01/2023 07:28:13 AM,11/01/2023 08:15:11 AM
2021/12/30,DPH Only,261,152,129,966,961,11,0,0,234414,125824,117910,51436,51370,129,0,0,11/01/2023 05:43:00 AM,11/01/2023 07:28:13 AM,11/01/2023 08:15:11 AM
2021/12/31,DPH Only,161,95,83,534,534,1,0,0,234575,125919,117993,51970,51904,130,0,0,11/01/2023 05:43:00 AM,11/01/2023 07:28:13 AM,11/01/2023 08:15:11 AM
2022/01/01,DPH Only,6,4,2,1,1,0,0,0,234581,125923,117995,51971,51905,130,0,0,11/01/2023 05:43:00 AM,11/01/2023 07:28:13 AM,11/01/2023 08:15:11 AM
2022/01/02,DPH Only,1,0,1,5,5,0,0,0,234582,125923,117996,51976,51910,130,0,0,11/01/2023 05:43:00 AM,11/01/2023 07:28:13 AM,11/01/2023 08:15:11 AM
2022/01/03,DPH Only,177,110,82,757,755,3,0,0,234759,126033,118078,52733,52665,133,0,0,11/01/2023 05:43:00 AM,11/01/2023 07:28:13 AM,11/01/2023 08:15:11 AM
2022/01/04,DPH Only,142,92,63,659,657,6,0,0,234901,126125,118141,53392,53322,139,0,0,11/01/2023 05:43:00 AM,11/01/2023 07:28:13 AM,11/01/2023 08:15:11 AM
2022/01/05,DPH Only,209,147,77,673,671,10,0,0,235110,126272,118218,54065,53993,149,0,0,11/01/2023 05:43:00 AM,11/01/2023 07:28:13 AM,11/01/2023 08:15:11 AM
2022/01/06,DPH Only,265,176,107,832,831,6,0,0,235375,126448,118325,54897,54824,155,0,0,11/01/2023 05:43:00 AM,11/01/2023 07:28:13 AM,11/01/2023 08:15:11 AM
2022/01/07,DPH Only,309,210,135,1081,1077,6,0,0,235684,126658,118460,55978,55901,161,0,0,11/01/2023 05:43:00 AM,11/01/2023 07:28:13 AM,11/01/2023 08:15:11 AM
2022/01/08,DPH Only,237,103,161,547,546,2,0,0,235921,126761,118621,56525,56447,163,0,0,11/01/2023 05:43:00 AM,11/01/2023 07:28:13 AM,11/01/2023 08:15:11 AM
2022/01/09,DPH Only,1,1,0,1,1,0,0,0,235922,126762,118621,56526,56448,163,0,0,11/01/2023 05:43:00 AM,11/01/2023 07:28:13 AM,11/01/2023 08:15:11 AM
2022/01/10,DPH Only,182,118,73,655,648,8,0,0,236104,126880,118694,57181,57096,171,0,0,11/01/2023 05:43:00 AM,11/01/2023 07:28:13 AM,11/01/2023 08:15:11 AM
2022/01/11,DPH Only,178,119,80,530,527,7,0,0,236282,126999,118774,57711,57623,178,0,0,11/01/2023 05:43:00 AM,11/01/2023 07:28:13 AM,11/01/2023 08:15:11 AM
2022/01/12,DPH Only,147,107,54,436,434,2,0,0,236429,127106,118828,58147,58057,180,0,0,11/01/2023 05:43:00 AM,11/01/2023 07:28:13 AM,11/01/2023 08:15:11 AM
2022/01/13,DPH Only,144,103,59,554,552,3,0,0,236573,127209,118887,58701,58609,183,0,0,11/01/2023 05:43:00 AM,11/01/2023 07:28:13 AM,11/01/2023 08:15:11 AM
2022/01/14,DPH Only,181,132,67,649,643,8,0,0,236754,127341,118954,59350,59252,191,0,0,11/01/2023 05:43:00 AM,11/01/2023 07:28:13 AM,11/01/2023 08:15:11 AM
2022/01/15,DPH Only,83,54,48,249,249,2,0,0,236837,127395,119002,59599,59501,193,0,0,11/01/2023 05:43:00 AM,11/01/2023 07:28:13 AM,11/01/2023 08:15:11 AM
2022/01/16,DPH Only,1,1,0,6,6,0,0,0,236838,127396,119002,59605,59507,193,0,0,11/01/2023 05:43:00 AM,11/01/2023 07:28:13 AM,11/01/2023 08:15:11 AM
2022/01/17,DPH Only,102,54,54,227,223,5,0,0,236940,127450,119056,59832,59730,198,0,0,11/01/2023 05:43:00 AM,11/01/2023 07:28:13 AM,11/01/2023 08:15:11 AM
2022/01/18,DPH Only,116,79,49,363,361,5,0,0,237056,127529,119105,60195,60091,203,0,0,11/01/2023 05:43:00 AM,11/01/2023 07:28:13 AM,11/01/2023 08:15:11 AM
2022/01/19,DPH Only,117,66,55,342,340,4,0,0,237173,127595,119160,60537,60431,207,0,0,11/01/2023 05:43:00 AM,11/01/2023 07:28:13 AM,11/01/2023 08:15:11 AM
2022/01/20,DPH Only,120,65,69,337,335,5,0,0,237293,127660,119229,60874,60766,212,0,0,11/01/2023 05:43:00 AM,11/01/2023 07:28:13 AM,11/01/2023 08:15:11 AM
2022/01/21,DPH Only,207,127,94,457,451,7,0,0,237500,127787,119323,61331,61217,219,0,0,11/01/2023 05:43:00 AM,11/01/2023 07:28:13 AM,11/01/2023 08:15:11 AM
2022/01/22,DPH Only,74,46,38,152,151,1,0,0,237574,127833,119361,61483,61368,220,0,0,11/01/2023 05:43:00 AM,11/01/2023 07:28:13 AM,11/01/2023 08:15:11 AM
2022/01/23,DPH Only,2,1,1,4,4,0,0,0,237576,127834,119362,61487,61372,220,0,0,11/01/2023 05:43:00 AM,11/01/2023 07:28:13 AM,11/01/2023 08:15:11 AM
2022/01/24,DPH Only,123,68,59,355,350,6,0,0,237699,127902,119421,61842,61722,226,0,0,11/01/2023 05:43:00 AM,11/01/2023 07:28:13 AM,11/01/2023 08:15:11 AM
2022/01/25,DPH Only,89,44,51,252,249,6,0,0,237788,127946,119472,62094,61971,232,0,0,11/01/2023 05:43:00 AM,11/01/2023 07:28:13 AM,11/01/2023 08:15:11 AM
2022/01/26,DPH Only,129,55,79,244,234,12,0,0,237917,128001,119551,62338,62205,244,0,0,11/01/2023 05:43:00 AM,11/01/2023 07:28:13 AM,11/01/2023 08:15:11 AM
2022/01/27,DPH Only,116,54,74,311,305,8,0,0,238033,128055,119625,62649,62510,252,0,0,11/01/2023 05:43:00 AM,11/01/2023 07:28:13 AM,11/01/2023 08:15:11 AM
2022/01/28,DPH Only,169,61,114,325,314,14,0,0,238202,128116,119739,62974,62824,266,0,0,11/01/2023 05:43:00 AM,11/01/2023 07:28:13 AM,11/01/2023 08:15:11 AM
2022/01/29,DPH Only,81,39,53,97,95,2,0,0,238283,128155,119792,63071,62919,268,0,0,11/01/2023 05:43:00 AM,11/01/2023 07:28:13 AM,11/01/2023 08:15:11 AM
2022/01/30,DPH Only,3,1,2,3,3,0,0,0,238286,128156,119794,63074,62922,268,0,0,11/01/2023 05:43:00 AM,11/01/2023 07:28:13 AM,11/01/2023 08:15:11 AM
2022/01/31,DPH Only,103,42,68,254,230,24,0,0,238389,128198,119862,63328,63152,292,0,0,11/01/2023 05:43:00 AM,11/01/2023 07:28:13 AM,11/01/2023 08:15:11 AM
2022/02/01,DPH Only,111,45,71,202,192,11,0,0,238500,128243,119933,63530,63344,303,0,0,11/01/2023 05:43:00 AM,11/01/2023 07:28:13 AM,11/01/2023 08:15:11 AM
2022/02/02,DPH Only,95,41,69,197,174,26,0,0,238595,128284,120002,63727,63518,329,0,0,11/01/2023 05:43:00 AM,11/01/2023 07:28:13 AM,11/01/2023 08:15:11 AM
2022/02/03,DPH Only,76,26,53,192,177,16,0,0,238671,128310,120055,63919,63695,345,0,0,11/01/2023 05:43:00 AM,11/01/2023 07:28:13 AM,11/01/2023 08:15:11 AM
2022/02/04,DPH Only,154,52,114,288,260,30,0,0,238825,128362,120169,64207,63955,375,0,0,11/01/2023 05:43:00 AM,11/01/2023 07:28:13 AM,11/01/2023 08:15:11 AM
2022/02/05,DPH Only,52,20,36,54,49,5,0,0,238877,128382,120205,64261,64004,380,0,0,11/01/2023 05:43:00 AM,11/01/2023 07:28:13 AM,11/01/2023 08:15:11 AM
2022/02/06,DPH Only,2,1,1,0,0,0,0,0,238879,128383,120206,64261,64004,380,0,0,11/01/2023 05:43:00 AM,11/01/2023 07:28:13 AM,11/01/2023 08:15:11 AM
2022/02/07,DPH Only,93,43,58,191,173,20,0,0,238972,128426,120264,64452,64177,400,0,0,11/01/2023 05:43:00 AM,11/01/2023 07:28:13 AM,11/01/2023 08:15:11 AM
2022/02/08,DPH Only,84,44,46,150,137,14,0,0,239056,128470,120310,64602,64314,414,0,0,11/01/2023 05:43:00 AM,11/01/2023 07:28:13 AM,11/01/2023 08:15:11 AM
2022/02/09,DPH Only,89,37,56,202,188,19,0,0,239145,128507,120366,64804,64502,433,0,0,11/01/2023 05:43:00 AM,11/01/2023 07:28:13 AM,11/01/2023 08:15:11 AM
2022/02/10,DPH Only,70,32,42,169,157,14,0,0,239215,128539,120408,64973,64659,447,0,0,11/01/2023 05:43:00 AM,11/01/2023 07:28:13 AM,11/01/2023 08:15:11 AM
2022/02/11,DPH Only,126,47,83,225,209,19,0,0,239341,128586,120491,65198,64868,466,0,0,11/01/2023 05:43:00 AM,11/01/2023 07:28:13 AM,11/01/2023 08:15:11 AM
2022/02/12,DPH Only,66,27,43,57,54,3,0,0,239407,128613,120534,65255,64922,469,0,0,11/01/2023 05:43:00 AM,11/01/2023 07:28:13 AM,11/01/2023 08:15:11 AM
2022/02/13,DPH Only,0,0,0,1,1,0,0,0,239407,128613,120534,65256,64923,469,0,0,11/01/2023 05:43:00 AM,11/01/2023 07:28:13 AM,11/01/2023 08:15:11 AM
2022/02/14,DPH Only,64,30,40,126,113,16,0,0,239471,128643,120574,65382,65036,485,0,0,11/01/2023 05:43:00 AM,11/01/2023 07:28:13 AM,11/01/2023 08:15:11 AM
2022/02/15,DPH Only,77,36,48,125,111,14,0,0,239548,128679,120622,65507,65147,499,0,0,11/01/2023 05:43:00 AM,11/01/2023 07:28:13 AM,11/01/2023 08:15:11 AM
2022/02/16,DPH Only,73,27,47,185,170,15,0,0,239621,128706,120669,65692,65317,514,0,0,11/01/2023 05:43:00 AM,11/01/2023 07:28:13 AM,11/01/2023 08:15:11 AM
2022/02/17,DPH Only,58,30,38,190,181,10,0,0,239679,128736,120707,65882,65498,524,0,0,11/01/2023 05:43:00 AM,11/01/2023 07:28:13 AM,11/01/2023 08:15:11 AM
2022/02/18,DPH Only,107,60,51,225,207,21,0,0,239786,128796,120758,66107,65705,545,0,0,11/01/2023 05:43:00 AM,11/01/2023 07:28:13 AM,11/01/2023 08:15:11 AM
2022/02/19,DPH Only,32,10,26,34,34,1,0,0,239818,128806,120784,66141,65739,546,0,0,11/01/2023 05:43:00 AM,11/01/2023 07:28:13 AM,11/01/2023 08:15:11 AM
2022/02/20,DPH Only,1,0,1,4,4,0,0,0,239819,128806,120785,66145,65743,546,0,0,11/01/2023 05:43:00 AM,11/01/2023 07:28:13 AM,11/01/2023 08:15:11 AM
2022/02/21,DPH Only,23,14,10,60,53,8,0,0,239842,128820,120795,66205,65796,554,0,0,11/01/2023 05:43:00 AM,11/01/2023 07:28:13 AM,11/01/2023 08:15:11 AM
2022/02/22,DPH Only,49,18,35,136,121,17,0,0,239891,128838,120830,66341,65917,571,0,0,11/01/2023 05:43:00 AM,11/01/2023 07:28:13 AM,11/01/2023 08:15:11 AM
2022/02/23,DPH Only,67,33,44,187,181,7,0,0,239958,128871,120874,66528,66098,578,0,0,11/01/2023 05:43:00 AM,11/01/2023 07:28:13 AM,11/01/2023 08:15:11 AM
2022/02/24,DPH Only,50,29,25,152,137,16,0,0,240008,128900,120899,66680,66235,594,0,0,11/01/2023 05:43:00 AM,11/01/2023 07:28:13 AM,11/01/2023 08:15:11 AM
2022/02/25,DPH Only,75,48,37,251,235,19,0,0,240083,128948,120936,66931,66470,613,0,0,11/01/2023 05:43:00 AM,11/01/2023 07:28:13 AM,11/01/2023 08:15:11 AM
2022/02/26,DPH Only,28,15,15,55,55,1,0,0,240111,128963,120951,66986,66525,614,0,0,11/01/2023 05:43:00 AM,11/01/2023 07:28:13 AM,11/01/2023 08:15:11 AM
2022/02/27,DPH Only,2,1,1,0,0,0,0,0,240113,128964,120952,66986,66525,614,0,0,11/01/2023 05:43:00 AM,11/01/2023 07:28:13 AM,11/01/2023 08:15:11 AM
2022/02/28,DPH Only,57,34,28,147,133,20,0,0,240170,128998,120980,67133,66658,634,0,0,11/01/2023 05:43:00 AM,11/01/2023 07:28:13 AM,11/01/2023 08:15:11 AM
2022/03/01,DPH Only,54,28,33,136,118,20,0,0,240224,129026,121013,67269,66776,654,0,0,11/01/2023 05:43:00 AM,11/01/2023 07:28:13 AM,11/01/2023 08:15:11 AM
2022/03/02,DPH Only,51,28,29,121,104,17,0,0,240275,129054,121042,67390,66880,671,0,0,11/01/2023 05:43:00 AM,11/01/2023 07:28:13 AM,11/01/2023 08:15:11 AM
2022/03/03,DPH Only,43,33,17,102,92,12,0,0,240318,129087,121059,67492,66972,683,0,0,11/01/2023 05:43:00 AM,11/01/2023 07:28:13 AM,11/01/2023 08:15:11 AM
2022/03/04,DPH Only,75,46,39,184,164,22,0,0,240393,129133,121098,67676,67136,705,0,0,11/01/2023 05:43:00 AM,11/01/2023 07:28:13 AM,11/01/2023 08:15:11 AM
2022/03/05,DPH Only,23,12,12,20,19,2,0,0,240416,129145,121110,67696,67155,707,0,0,11/01/2023 05:43:00 AM,11/01/2023 07:28:13 AM,11/01/2023 08:15:11 AM
2022/03/06,DPH Only,1,0,1,0,0,0,0,0,240417,129145,121111,67696,67155,707,0,0,11/01/2023 05:43:00 AM,11/01/2023 07:28:13 AM,11/01/2023 08:15:11 AM
2022/03/07,DPH Only,52,33,26,114,107,10,0,0,240469,129178,121137,67810,67262,717,0,0,11/01/2023 05:43:00 AM,11/01/2023 07:28:13 AM,11/01/2023 08:15:11 AM
2022/03/08,DPH Only,32,18,15,80,76,8,0,0,240501,129196,121152,67890,67338,725,0,0,11/01/2023 05:43:00 AM,11/01/2023 07:28:13 AM,11/01/2023 08:15:11 AM
2022/03/09,DPH Only,37,24,14,81,69,13,0,0,240538,129220,121166,67971,67407,738,0,0,11/01/2023 05:43:00 AM,11/01/2023 07:28:13 AM,11/01/2023 08:15:11 AM
2022/03/10,DPH Only,48,22,33,124,110,14,0,0,240586,129242,121199,68095,67517,752,0,0,11/01/2023 05:43:00 AM,11/01/2023 07:28:13 AM,11/01/2023 08:15:11 AM
2022/03/11,DPH Only,80,36,49,128,115,18,0,0,240666,129278,121248,68223,67632,770,0,0,11/01/2023 05:43:00 AM,11/01/2023 07:28:13 AM,11/01/2023 08:15:11 AM
2022/03/12,DPH Only,15,10,6,35,35,1,0,0,240681,129288,121254,68258,67667,771,0,0,11/01/2023 05:43:00 AM,11/01/2023 07:28:13 AM,11/01/2023 08:15:11 AM
2022/03/13,DPH Only,0,0,0,1,1,0,0,0,240681,129288,121254,68259,67668,771,0,0,11/01/2023 05:43:00 AM,11/01/2023 07:28:13 AM,11/01/2023 08:15:11 AM
2022/03/14,DPH Only,33,20,19,85,76,10,0,0,240714,129308,121273,68344,67744,781,0,0,11/01/2023 05:43:00 AM,11/01/2023 07:28:13 AM,11/01/2023 08:15:11 AM
2022/03/15,DPH Only,28,18,13,104,91,13,0,0,240742,129326,121286,68448,67835,794,0,0,11/01/2023 05:43:00 AM,11/01/2023 07:28:13 AM,11/01/2023 08:15:11 AM
2022/03/16,DPH Only,42,20,28,89,70,20,0,0,240784,129346,121314,68537,67905,814,0,0,11/01/2023 05:43:00 AM,11/01/2023 07:28:13 AM,11/01/2023 08:15:11 AM
2022/03/17,DPH Only,45,20,30,95,85,15,0,0,240829,129366,121344,68632,67990,829,0,0,11/01/2023 05:43:00 AM,11/01/2023 07:28:13 AM,11/01/2023 08:15:11 AM
2022/03/18,DPH Only,76,45,37,165,149,17,0,0,240905,129411,121381,68797,68139,846,0,0,11/01/2023 05:43:00 AM,11/01/2023 07:28:13 AM,11/01/2023 08:15:11 AM
2022/03/19,DPH Only,19,10,10,17,17,2,0,0,240924,129421,121391,68814,68156,848,0,0,11/01/2023 05:43:00 AM,11/01/2023 07:28:13 AM,11/01/2023 08:15:11 AM
2022/03/20,DPH Only,0,0,0,2,2,1,0,0,240924,129421,121391,68816,68158,849,0,0,11/01/2023 05:43:00 AM,11/01/2023 07:28:13 AM,11/01/2023 08:15:11 AM
2022/03/21,DPH Only,31,18,15,88,75,17,0,0,240955,129439,121406,68904,68233,866,0,0,11/01/2023 05:43:00 AM,11/01/2023 07:28:13 AM,11/01/2023 08:15:11 AM
2022/03/22,DPH Only,27,18,12,69,57,13,0,0,240982,129457,121418,68973,68290,879,0,0,11/01/2023 05:43:00 AM,11/01/2023 07:28:13 AM,11/01/2023 08:15:11 AM
2022/03/23,DPH Only,32,20,18,96,74,25,0,0,241014,129477,121436,69069,68364,904,0,0,11/01/2023 05:43:00 AM,11/01/2023 07:28:13 AM,11/01/2023 08:15:11 AM
2022/03/24,DPH Only,40,23,23,82,71,13,0,0,241054,129500,121459,69151,68435,917,0,0,11/01/2023 05:43:00 AM,11/01/2023 07:28:13 AM,11/01/2023 08:15:11 AM
2022/03/25,DPH Only,46,24,24,101,91,12,0,0,241100,129524,121483,69252,68526,929,0,0,11/01/2023 05:43:00 AM,11/01/2023 07:28:13 AM,11/01/2023 08:15:11 AM
2022/03/26,DPH Only,15,11,5,21,21,0,0,0,241115,129535,121488,69273,68547,929,0,0,11/01/2023 05:43:00 AM,11/01/2023 07:28:13 AM,11/01/2023 08:15:11 AM
2022/03/27,DPH Only,4,2,2,3,3,0,0,0,241119,129537,121490,69276,68550,929,0,0,11/01/2023 05:43:00 AM,11/01/2023 07:28:13 AM,11/01/2023 08:15:11 AM
2022/03/28,DPH Only,42,20,23,88,76,16,0,0,241161,129557,121513,69364,68626,945,0,0,11/01/2023 05:43:00 AM,11/01/2023 07:28:13 AM,11/01/2023 08:15:11 AM
2022/03/29,DPH Only,25,10,15,84,75,9,0,0,241186,129567,121528,69448,68701,954,0,0,11/01/2023 05:43:00 AM,11/01/2023 07:28:13 AM,11/01/2023 08:15:11 AM
2022/03/30,DPH Only,23,14,10,96,74,27,0,0,241209,129581,121538,69544,68775,981,0,0,11/01/2023 05:43:00 AM,11/01/2023 07:28:13 AM,11/01/2023 08:15:11 AM
2022/03/31,DPH Only,43,23,26,110,80,35,0,0,241252,129604,121564,69654,68855,1016,0,0,11/01/2023 05:43:00 AM,11/01/2023 07:28:13 AM,11/01/2023 08:15:11 AM
2022/04/01,DPH Only,46,25,25,200,103,121,0,0,241298,129629,121589,69854,68958,1137,0,0,11/01/2023 05:43:00 AM,11/01/2023 07:28:13 AM,11/01/2023 08:15:11 AM
2022/04/02,DPH Only,13,4,10,80,51,62,0,0,241311,129633,121599,69934,69009,1199,0,0,11/01/2023 05:43:00 AM,11/01/2023 07:28:13 AM,11/01/2023 08:15:11 AM
2022/04/03,DPH Only,2,1,1,2,2,0,0,0,241313,129634,121600,69936,69011,1199,0,0,11/01/2023 05:43:00 AM,11/01/2023 07:28:13 AM,11/01/2023 08:15:11 AM
2022/04/04,DPH Only,35,15,23,163,86,100,0,0,241348,129649,121623,70099,69097,1299,0,0,11/01/2023 05:43:00 AM,11/01/2023 07:28:13 AM,11/01/2023 08:15:11 AM
2022/04/05,DPH Only,36,23,20,169,86,106,0,0,241384,129672,121643,70268,69183,1405,0,0,11/01/2023 05:43:00 AM,11/01/2023 07:28:13 AM,11/01/2023 08:15:11 AM
2022/04/06,DPH Only,25,17,11,199,89,135,0,0,241409,129689,121654,70467,69272,1540,0,0,11/01/2023 05:43:00 AM,11/01/2023 07:28:13 AM,11/01/2023 08:15:11 AM
2022/04/07,DPH Only,38,21,19,212,97,157,0,0,241447,129710,121673,70679,69369,1697,0,0,11/01/2023 05:43:00 AM,11/01/2023 07:28:13 AM,11/01/2023 08:15:11 AM
2022/04/08,DPH Only,50,20,32,312,134,229,0,0,241497,129730,121705,70991,69503,1926,0,0,11/01/2023 05:43:00 AM,11/01/2023 07:28:13 AM,11/01/2023 08:15:11 AM
2022/04/09,DPH Only,6,4,3,62,27,49,0,0,241503,129734,121708,71053,69530,1975,0,0,11/01/2023 05:43:00 AM,11/01/2023 07:28:13 AM,11/01/2023 08:15:11 AM
2022/04/10,DPH Only,2,1,1,6,4,4,0,0,241505,129735,121709,71059,69534,1979,0,0,11/01/2023 05:43:00 AM,11/01/2023 07:28:13 AM,11/01/2023 08:15:11 AM
2022/04/11,DPH Only,21,11,13,193,79,147,0,0,241526,129746,121722,71252,69613,2126,0,0,11/01/2023 05:43:00 AM,11/01/2023 07:28:13 AM,11/01/2023 08:15:11 AM
2022/04/12,DPH Only,26,17,12,175,55,135,0,0,241552,129763,121734,71427,69668,2261,0,0,11/01/2023 05:43:00 AM,11/01/2023 07:28:13 AM,11/01/2023 08:15:11 AM
2022/04/13,DPH Only,34,25,15,223,91,164,0,0,241586,129788,121749,71650,69759,2425,0,0,11/01/2023 05:43:00 AM,11/01/2023 07:28:13 AM,11/01/2023 08:15:11 AM
2022/04/14,DPH Only,28,16,14,224,87,165,0,0,241614,129804,121763,71874,69846,2590,0,0,11/01/2023 05:43:00 AM,11/01/2023 07:28:13 AM,11/01/2023 08:15:11 AM
2022/04/15,DPH Only,45,20,27,313,137,234,0,0,241659,129824,121790,72187,69983,2824,0,0,11/01/2023 05:43:00 AM,11/01/2023 07:28:13 AM,11/01/2023 08:15:11 AM
2022/04/16,DPH Only,25,14,13,53,32,41,0,0,241684,129838,121803,72240,70015,2865,0,0,11/01/2023 05:43:00 AM,11/01/2023 07:28:13 AM,11/01/2023 08:15:11 AM
2022/04/17,DPH Only,0,0,0,1,1,0,0,0,241684,129838,121803,72241,70016,2865,0,0,11/01/2023 05:43:00 AM,11/01/2023 07:28:13 AM,11/01/2023 08:15:11 AM
2022/04/18,DPH Only,28,21,14,261,86,216,0,0,241712,129859,121817,72502,70102,3081,0,0,11/01/2023 05:43:00 AM,11/01/2023 07:28:13 AM,11/01/2023 08:15:11 AM
2022/04/19,DPH Only,26,18,12,206,68,160,0,0,241738,129877,121829,72708,70170,3241,0,0,11/01/2023 05:43:00 AM,11/01/2023 07:28:13 AM,11/01/2023 08:15:11 AM
2022/04/20,DPH Only,25,17,11,215,66,176,0,0,241763,129894,121840,72923,70236,3417,0,0,11/01/2023 05:43:00 AM,11/01/2023 07:28:13 AM,11/01/2023 08:15:11 AM
2022/04/21,DPH Only,29,21,11,257,107,203,0,0,241792,129915,121851,73180,70343,3620,0,0,11/01/2023 05:43:00 AM,11/01/2023 07:28:13 AM,11/01/2023 08:15:11 AM
2022/04/22,DPH Only,36,19,21,286,133,217,0,0,241828,129934,121872,73466,70476,3837,0,0,11/01/2023 05:43:00 AM,11/01/2023 07:28:13 AM,11/01/2023 08:15:11 AM
2022/04/23,DPH Only,9,6,3,40,28,27,0,0,241837,129940,121875,73506,70504,3864,0,0,11/01/2023 05:43:00 AM,11/01/2023 07:28:13 AM,11/01/2023 08:15:11 AM
2022/04/24,DPH Only,2,1,1,0,0,0,0,0,241839,129941,121876,73506,70504,3864,0,0,11/01/2023 05:43:00 AM,11/01/2023 07:28:13 AM,11/01/2023 08:15:11 AM
2022/04/25,DPH Only,36,25,21,257,114,199,0,0,241875,129966,121897,73763,70618,4063,0,0,11/01/2023 05:43:00 AM,11/01/2023 07:28:13 AM,11/01/2023 08:15:11 AM
2022/04/26,DPH Only,27,17,13,213,86,166,0,0,241902,129983,121910,73976,70704,4229,0,0,11/01/2023 05:43:00 AM,11/01/2023 07:28:13 AM,11/01/2023 08:15:11 AM
2022/04/27,DPH Only,30,17,17,242,117,190,0,0,241932,130000,121927,74218,70821,4419,0,0,11/01/2023 05:43:00 AM,11/01/2023 07:28:13 AM,11/01/2023 08:15:11 AM
2022/04/28,DPH Only,30,19,12,383,113,327,0,0,241962,130019,121939,74601,70934,4746,0,0,11/01/2023 05:43:00 AM,11/01/2023 07:28:13 AM,11/01/2023 08:15:11 AM
2022/04/29,DPH Only,34,23,14,370,121,313,0,0,241996,130042,121953,74971,71055,5059,0,0,11/01/2023 05:43:00 AM,11/01/2023 07:28:13 AM,11/01/2023 08:15:11 AM
2022/04/30,DPH Only,1,1,1,29,17,22,0,0,241997,130043,121954,75000,71072,5081,0,0,11/01/2023 05:43:00 AM,11/01/2023 07:28:13 AM,11/01/2023 08:15:11 AM
2022/05/01,DPH Only,5,2,3,2,2,1,0,0,242002,130045,121957,75002,71074,5082,0,0,11/01/2023 05:43:00 AM,11/01/2023 07:28:13 AM,11/01/2023 08:15:11 AM
2022/05/02,DPH Only,34,26,13,282,83,230,0,0,242036,130071,121970,75284,71157,5312,0,0,11/01/2023 05:43:00 AM,11/01/2023 07:28:13 AM,11/01/2023 08:15:11 AM
2022/05/03,DPH Only,13,11,2,262,76,216,0,0,242049,130082,121972,75546,71233,5528,0,0,11/01/2023 05:43:00 AM,11/01/2023 07:28:13 AM,11/01/2023 08:15:11 AM
2022/05/04,DPH Only,26,14,16,256,90,205,0,0,242075,130096,121988,75802,71323,5733,0,0,11/01/2023 05:43:00 AM,11/01/2023 07:28:13 AM,11/01/2023 08:15:11 AM
2022/05/05,DPH Only,26,14,14,277,94,235,0,0,242101,130110,122002,76079,71417,5968,0,0,11/01/2023 05:43:00 AM,11/01/2023 07:28:13 AM,11/01/2023 08:15:11 AM
2022/05/06,DPH Only,23,12,13,314,118,264,0,0,242124,130122,122015,76393,71535,6232,0,0,11/01/2023 05:43:00 AM,11/01/2023 07:28:13 AM,11/01/2023 08:15:11 AM
2022/05/07,DPH Only,11,4,7,44,18,32,0,0,242135,130126,122022,76437,71553,6264,0,0,11/01/2023 05:43:00 AM,11/01/2023 07:28:13 AM,11/01/2023 08:15:11 AM
2022/05/08,DPH Only,0,0,0,1,1,0,0,0,242135,130126,122022,76438,71554,6264,0,0,11/01/2023 05:43:00 AM,11/01/2023 07:28:13 AM,11/01/2023 08:15:11 AM
2022/05/09,DPH Only,25,9,18,237,91,183,0,0,242160,130135,122040,76675,71645,6447,0,0,11/01/2023 05:43:00 AM,11/01/2023 07:28:13 AM,11/01/2023 08:15:11 AM
2022/05/10,DPH Only,17,10,9,188,63,149,0,0,242177,130145,122049,76863,71708,6596,0,0,11/01/2023 05:43:00 AM,11/01/2023 07:28:13 AM,11/01/2023 08:15:11 AM
2022/05/11,DPH Only,29,15,16,271,106,231,0,0,242206,130160,122065,77134,71814,6827,0,0,11/01/2023 05:43:00 AM,11/01/2023 07:28:13 AM,11/01/2023 08:15:11 AM
2022/05/12,DPH Only,22,12,11,299,99,247,0,0,242228,130172,122076,77433,71913,7074,0,0,11/01/2023 05:43:00 AM,11/01/2023 07:28:13 AM,11/01/2023 08:15:11 AM
2022/05/13,DPH Only,40,25,23,324,131,261,0,0,242268,130197,122099,77757,72044,7335,0,0,11/01/2023 05:43:00 AM,11/01/2023 07:28:13 AM,11/01/2023 08:15:11 AM
2022/05/14,DPH Only,11,6,6,58,35,38,0,0,242279,130203,122105,77815,72079,7373,0,0,11/01/2023 05:43:00 AM,11/01/2023 07:28:13 AM,11/01/2023 08:15:11 AM
2022/05/15,DPH Only,0,0,0,0,0,0,0,0,242279,130203,122105,77815,72079,7373,0,0,11/01/2023 05:43:00 AM,11/01/2023 07:28:13 AM,11/01/2023 08:15:11 AM
2022/05/16,DPH Only,20,13,10,276,116,216,0,0,242299,130216,122115,78091,72195,7589,0,0,11/01/2023 05:43:00 AM,11/01/2023 07:28:13 AM,11/01/2023 08:15:11 AM
2022/05/17,DPH Only,27,16,15,241,77,194,0,0,242326,130232,122130,78332,72272,7783,0,0,11/01/2023 05:43:00 AM,11/01/2023 07:28:13 AM,11/01/2023 08:15:11 AM
2022/05/18,DPH Only,20,15,8,281,109,219,0,0,242346,130247,122138,78613,72381,8002,0,0,11/01/2023 05:43:00 AM,11/01/2023 07:28:13 AM,11/01/2023 08:15:11 AM
2022/05/19,DPH Only,30,21,13,243,97,190,0,0,242376,130268,122151,78856,72478,8192,0,0,11/01/2023 05:43:00 AM,11/01/2023 07:28:13 AM,11/01/2023 08:15:11 AM
2022/05/20,DPH Only,31,18,17,333,151,253,0,0,242407,130286,122168,79189,72629,8445,0,0,11/01/2023 05:43:00 AM,11/01/2023 07:28:13 AM,11/01/2023 08:15:11 AM
2022/05/21,DPH Only,8,6,4,90,56,57,0,0,242415,130292,122172,79279,72685,8502,0,0,11/01/2023 05:43:00 AM,11/01/2023 07:28:13 AM,11/01/2023 08:15:11 AM
2022/05/22,DPH Only,0,0,0,5,3,3,0,0,242415,130292,122172,79284,72688,8505,0,0,11/01/2023 05:43:00 AM,11/01/2023 07:28:13 AM,11/01/2023 08:15:11 AM
2022/05/23,DPH Only,25,17,15,299,88,253,0,0,242440,130309,122187,79583,72776,8758,0,0,11/01/2023 05:43:00 AM,11/01/2023 07:28:13 AM,11/01/2023 08:15:11 AM
2022/05/24,DPH Only,20,12,10,215,82,168,0,0,242460,130321,122197,79798,72858,8926,0,0,11/01/2023 05:43:00 AM,11/01/2023 07:28:13 AM,11/01/2023 08:15:11 AM
2022/05/25,DPH Only,42,22,27,293,99,242,0,0,242502,130343,122224,80091,72957,9168,0,0,11/01/2023 05:43:00 AM,11/01/2023 07:28:13 AM,11/01/2023 08:15:11 AM
2022/05/26,DPH Only,23,15,12,219,101,181,0,0,242525,130358,122236,80310,73058,9349,0,0,11/01/2023 05:43:00 AM,11/01/2023 07:28:13 AM,11/01/2023 08:15:11 AM
2022/05/27,DPH Only,29,24,13,302,132,225,0,0,242554,130382,122249,80612,73190,9574,0,0,11/01/2023 05:43:00 AM,11/01/2023 07:28:13 AM,11/01/2023 08:15:11 AM
2022/05/28,DPH Only,5,3,3,63,49,27,0,0,242559,130385,122252,80675,73239,9601,0,0,11/01/2023 05:43:00 AM,11/01/2023 07:28:13 AM,11/01/2023 08:15:11 AM
2022/05/29,DPH Only,2,2,0,0,0,0,0,0,242561,130387,122252,80675,73239,9601,0,0,11/01/2023 05:43:00 AM,11/01/2023 07:28:13 AM,11/01/2023 08:15:11 AM
2022/05/30,DPH Only,5,4,4,13,9,6,0,0,242566,130391,122256,80688,73248,9607,0,0,11/01/2023 05:43:00 AM,11/01/2023 07:28:13 AM,11/01/2023 08:15:11 AM
2022/05/31,DPH Only,28,17,17,239,86,195,0,0,242594,130408,122273,80927,73334,9802,0,0,11/01/2023 05:43:00 AM,11/01/2023 07:28:13 AM,11/01/2023 08:15:11 AM
2022/06/01,DPH Only,27,21,9,265,112,196,0,0,242621,130429,122282,81192,73446,9998,0,0,11/01/2023 05:43:00 AM,11/01/2023 07:28:13 AM,11/01/2023 08:15:11 AM
2022/06/02,DPH Only,26,18,9,284,141,209,0,0,242647,130447,122291,81476,73587,10207,0,0,11/01/2023 05:43:00 AM,11/01/2023 07:28:13 AM,11/01/2023 08:15:11 AM
2022/06/03,DPH Only,23,13,13,307,152,216,0,0,242670,130460,122304,81783,73739,10423,0,0,11/01/2023 05:43:00 AM,11/01/2023 07:28:13 AM,11/01/2023 08:15:11 AM
2022/06/04,DPH Only,7,6,3,75,59,45,0,0,242677,130466,122307,81858,73798,10468,0,0,11/01/2023 05:43:00 AM,11/01/2023 07:28:13 AM,11/01/2023 08:15:11 AM
2022/06/05,DPH Only,1,0,1,1,1,0,0,0,242678,130466,122308,81859,73799,10468,0,0,11/01/2023 05:43:00 AM,11/01/2023 07:28:13 AM,11/01/2023 08:15:11 AM
2022/06/06,DPH Only,29,10,22,208,72,153,0,0,242707,130476,122330,82067,73871,10621,0,0,11/01/2023 05:43:00 AM,11/01/2023 07:28:13 AM,11/01/2023 08:15:11 AM
2022/06/07,DPH Only,26,19,12,194,80,145,0,0,242733,130495,122342,82261,73951,10766,0,0,11/01/2023 05:43:00 AM,11/01/2023 07:28:13 AM,11/01/2023 08:15:11 AM
2022/06/08,DPH Only,21,14,11,283,157,230,0,0,242754,130509,122353,82544,74108,10996,0,0,11/01/2023 05:43:00 AM,11/01/2023 07:28:13 AM,11/01/2023 08:15:11 AM
2022/06/09,DPH Only,31,23,16,337,163,273,0,0,242785,130532,122369,82881,74271,11269,0,0,11/01/2023 05:43:00 AM,11/01/2023 07:28:13 AM,11/01/2023 08:15:11 AM
2022/06/10,DPH Only,33,21,14,271,134,201,0,0,242818,130553,122383,83152,74405,11470,0,0,11/01/2023 05:43:00 AM,11/01/2023 07:28:13 AM,11/01/2023 08:15:11 AM
2022/06/11,DPH Only,4,3,1,27,15,18,0,0,242822,130556,122384,83179,74420,11488,0,0,11/01/2023 05:43:00 AM,11/01/2023 07:28:13 AM,11/01/2023 08:15:11 AM
2022/06/12,DPH Only,1,1,1,12,7,9,0,0,242823,130557,122385,83191,74427,11497,0,0,11/01/2023 05:43:00 AM,11/01/2023 07:28:13 AM,11/01/2023 08:15:11 AM
2022/06/13,DPH Only,22,12,14,166,69,123,0,0,242845,130569,122399,83357,74496,11620,0,0,11/01/2023 05:43:00 AM,11/01/2023 07:28:13 AM,11/01/2023 08:15:11 AM
2022/06/14,DPH Only,11,11,4,152,62,118,0,0,242856,130580,122403,83509,74558,11738,0,0,11/01/2023 05:43:00 AM,11/01/2023 07:28:13 AM,11/01/2023 08:15:11 AM
2022/06/15,DPH Only,16,12,7,220,85,180,0,0,242872,130592,122410,83729,74643,11918,0,0,11/01/2023 05:43:00 AM,11/01/2023 07:28:13 AM,11/01/2023 08:15:11 AM
2022/06/16,DPH Only,35,24,15,189,98,139,0,0,242907,130616,122425,83918,74741,12057,0,0,11/01/2023 05:43:00 AM,11/01/2023 07:28:13 AM,11/01/2023 08:15:11 AM
2022/06/17,DPH Only,36,28,14,230,116,171,0,0,242943,130644,122439,84148,74857,12228,0,0,11/01/2023 05:43:00 AM,11/01/2023 07:28:13 AM,11/01/2023 08:15:11 AM
2022/06/18,DPH Only,7,6,2,38,22,24,0,0,242950,130650,122441,84186,74879,12252,0,0,11/01/2023 05:43:00 AM,11/01/2023 07:28:13 AM,11/01/2023 08:15:11 AM
2022/06/19,DPH Only,1,1,0,7,6,2,0,0,242951,130651,122441,84193,74885,12254,0,0,11/01/2023 05:43:00 AM,11/01/2023 07:28:13 AM,11/01/2023 08:15:11 AM
2022/06/20,DPH Only,8,6,2,39,19,24,0,0,242959,130657,122443,84232,74904,12278,0,0,11/01/2023 05:43:00 AM,11/01/2023 07:28:13 AM,11/01/2023 08:15:11 AM
2022/06/21,DPH Only,13,9,5,151,69,109,0,0,242972,130666,122448,84383,74973,12387,0,0,11/01/2023 05:43:00 AM,11/01/2023 07:28:13 AM,11/01/2023 08:15:11 AM
2022/06/22,DPH Only,16,10,6,262,153,205,0,0,242988,130676,122454,84645,75126,12592,0,0,11/01/2023 05:43:00 AM,11/01/2023 07:28:13 AM,11/01/2023 08:15:11 AM
2022/06/23,DPH Only,31,21,14,224,114,182,0,0,243019,130697,122468,84869,75240,12774,0,0,11/01/2023 05:43:00 AM,11/01/2023 07:28:13 AM,11/01/2023 08:15:11 AM
2022/06/24,DPH Only,66,57,12,193,82,138,0,0,243085,130754,122480,85062,75322,12912,0,0,11/01/2023 05:43:00 AM,11/01/2023 07:28:13 AM,11/01/2023 08:15:11 AM
2022/06/25,DPH Only,39,37,2,20,17,9,0,0,243124,130791,122482,85082,75339,12921,0,0,11/01/2023 05:43:00 AM,11/01/2023 07:28:13 AM,11/01/2023 08:15:11 AM
2022/06/26,DPH Only,0,0,0,2,2,1,0,0,243124,130791,122482,85084,75341,12922,0,0,11/01/2023 05:43:00 AM,11/01/2023 07:28:13 AM,11/01/2023 08:15:11 AM
2022/06/27,DPH Only,36,26,12,160,72,113,0,0,243160,130817,122494,85244,75413,13035,0,0,11/01/2023 05:43:00 AM,11/01/2023 07:28:13 AM,11/01/2023 08:15:11 AM
2022/06/28,DPH Only,26,17,13,157,70,123,0,0,243186,130834,122507,85401,75483,13158,0,0,11/01/2023 05:43:00 AM,11/01/2023 07:28:13 AM,11/01/2023 08:15:11 AM
2022/06/29,DPH Only,36,24,17,160,61,126,0,0,243222,130858,122524,85561,75544,13284,0,0,11/01/2023 05:43:00 AM,11/01/2023 07:28:13 AM,11/01/2023 08:15:11 AM
2022/06/30,DPH Only,24,15,10,166,73,130,0,0,243246,130873,122534,85727,75617,13414,0,0,11/01/2023 05:43:00 AM,11/01/2023 07:28:13 AM,11/01/2023 08:15:11 AM
2022/07/01,DPH Only,23,20,7,181,84,135,0,0,243269,130893,122541,85908,75701,13549,0,0,11/01/2023 05:43:00 AM,11/01/2023 07:28:13 AM,11/01/2023 08:15:11 AM
2022/07/02,DPH Only,3,3,0,21,15,8,0,0,243272,130896,122541,85929,75716,13557,0,0,11/01/2023 05:43:00 AM,11/01/2023 07:28:13 AM,11/01/2023 08:15:11 AM
2022/07/03,DPH Only,1,1,1,4,2,3,0,0,243273,130897,122542,85933,75718,13560,0,0,11/01/2023 05:43:00 AM,11/01/2023 07:28:13 AM,11/01/2023 08:15:11 AM
2022/07/04,DPH Only,7,6,2,18,14,8,0,0,243280,130903,122544,85951,75732,13568,0,0,11/01/2023 05:43:00 AM,11/01/2023 07:28:13 AM,11/01/2023 08:15:11 AM
2022/07/05,DPH Only,27,21,8,151,72,99,0,0,243307,130924,122552,86102,75804,13667,0,0,11/01/2023 05:43:00 AM,11/01/2023 07:28:13 AM,11/01/2023 08:15:11 AM
2022/07/06,DPH Only,24,19,7,147,64,98,0,0,243331,130943,122559,86249,75868,13765,0,0,11/01/2023 05:43:00 AM,11/01/2023 07:28:13 AM,11/01/2023 08:15:11 AM
2022/07/07,DPH Only,25,16,12,166,82,123,0,0,243356,130959,122571,86415,75950,13888,0,0,11/01/2023 05:43:00 AM,11/01/2023 07:28:13 AM,11/01/2023 08:15:11 AM
2022/07/08,DPH Only,44,31,15,168,74,123,0,0,243400,130990,122586,86583,76024,14011,0,0,11/01/2023 05:43:00 AM,11/01/2023 07:28:13 AM,11/01/2023 08:15:11 AM
2022/07/09,DPH Only,11,9,2,9,7,2,0,0,243411,130999,122588,86592,76031,14013,0,0,11/01/2023 05:43:00 AM,11/01/2023 07:28:13 AM,11/01/2023 08:15:11 AM
2022/07/10,DPH Only,4,3,1,8,5,3,0,0,243415,131002,122589,86600,76036,14016,0,0,11/01/2023 05:43:00 AM,11/01/2023 07:28:13 AM,11/01/2023 08:15:11 AM
2022/07/11,DPH Only,29,22,10,157,62,106,0,0,243444,131024,122599,86757,76098,14122,0,0,11/01/2023 05:43:00 AM,11/01/2023 07:28:13 AM,11/01/2023 08:15:11 AM
2022/07/12,DPH Only,35,24,12,145,63,95,0,0,243479,131048,122611,86902,76161,14217,0,0,11/01/2023 05:43:00 AM,11/01/2023 07:28:13 AM,11/01/2023 08:15:11 AM
2022/07/13,DPH Only,32,26,12,168,61,132,0,0,243511,131074,122623,87070,76222,14349,0,0,11/01/2023 05:43:00 AM,11/01/2023 07:28:13 AM,11/01/2023 08:15:11 AM
2022/07/14,DPH Only,32,27,10,191,96,128,0,0,243543,131101,122633,87261,76318,14477,0,0,11/01/2023 05:43:00 AM,11/01/2023 07:28:13 AM,11/01/2023 08:15:11 AM
2022/07/15,DPH Only,43,28,18,205,88,153,0,0,243586,131129,122651,87466,76406,14630,0,0,11/01/2023 05:43:00 AM,11/01/2023 07:28:13 AM,11/01/2023 08:15:11 AM
2022/07/16,DPH Only,13,8,5,39,25,22,0,0,243599,131137,122656,87505,76431,14652,0,0,11/01/2023 05:43:00 AM,11/01/2023 07:28:13 AM,11/01/2023 08:15:11 AM
2022/07/17,DPH Only,0,0,0,1,1,0,0,0,243599,131137,122656,87506,76432,14652,0,0,11/01/2023 05:43:00 AM,11/01/2023 07:28:13 AM,11/01/2023 08:15:11 AM
2022/07/18,DPH Only,38,22,20,143,75,94,0,0,243637,131159,122676,87649,76507,14746,0,0,11/01/2023 05:43:00 AM,11/01/2023 07:28:13 AM,11/01/2023 08:15:11 AM
2022/07/19,DPH Only,29,22,8,140,60,104,0,0,243666,131181,122684,87789,76567,14850,0,0,11/01/2023 05:43:00 AM,11/01/2023 07:28:13 AM,11/01/2023 08:15:11 AM
2022/07/20,DPH Only,24,15,9,101,49,69,0,0,243690,131196,122693,87890,76616,14919,0,0,11/01/2023 05:43:00 AM,11/01/2023 07:28:13 AM,11/01/2023 08:15:11 AM
2022/07/21,DPH Only,32,24,14,134,63,92,0,0,243722,131220,122707,88024,76679,15011,0,0,11/01/2023 05:43:00 AM,11/01/2023 07:28:13 AM,11/01/2023 08:15:11 AM
2022/07/22,DPH Only,72,38,39,172,88,121,0,0,243794,131258,122746,88196,76767,15132,0,0,11/01/2023 05:43:00 AM,11/01/2023 07:28:13 AM,11/01/2023 08:15:11 AM
2022/07/23,DPH Only,38,19,23,20,15,7,0,0,243832,131277,122769,88216,76782,15139,0,0,11/01/2023 05:43:00 AM,11/01/2023 07:28:13 AM,11/01/2023 08:15:11 AM
2022/07/24,DPH Only,1,1,0,0,0,0,0,0,243833,131278,122769,88216,76782,15139,0,0,11/01/2023 05:43:00 AM,11/01/2023 07:28:13 AM,11/01/2023 08:15:11 AM
2022/07/25,DPH Only,21,13,9,127,60,77,0,0,243854,131291,122778,88343,76842,15216,0,0,11/01/2023 05:43:00 AM,11/01/2023 07:28:13 AM,11/01/2023 08:15:11 AM
2022/07/26,DPH Only,20,18,4,150,71,112,0,0,243874,131309,122782,88493,76913,15328,0,0,11/01/2023 05:43:00 AM,11/01/2023 07:28:13 AM,11/01/2023 08:15:11 AM
2022/07/27,DPH Only,25,18,9,111,58,81,0,0,243899,131327,122791,88604,76971,15409,0,0,11/01/2023 05:43:00 AM,11/01/2023 07:28:13 AM,11/01/2023 08:15:11 AM
2022/07/28,DPH Only,37,25,14,153,83,115,0,0,243936,131352,122805,88757,77054,15524,0,0,11/01/2023 05:43:00 AM,11/01/2023 07:28:13 AM,11/01/2023 08:15:11 AM
2022/07/29,DPH Only,52,38,17,128,65,78,0,0,243988,131390,122822,88885,77119,15602,0,0,11/01/2023 05:43:00 AM,11/01/2023 07:28:13 AM,11/01/2023 08:15:11 AM
2022/07/30,DPH Only,14,6,10,10,8,4,0,0,244002,131396,122832,88895,77127,15606,0,0,11/01/2023 05:43:00 AM,11/01/2023 07:28:13 AM,11/01/2023 08:15:11 AM
2022/07/31,DPH Only,0,0,0,1,1,0,0,0,244002,131396,122832,88896,77128,15606,0,0,11/01/2023 05:43:00 AM,11/01/2023 07:28:13 AM,11/01/2023 08:15:11 AM
2022/08/01,DPH Only,29,14,19,86,43,55,0,0,244031,131410,122851,88982,77171,15661,0,0,11/01/2023 05:43:00 AM,11/01/2023 07:28:13 AM,11/01/2023 08:15:11 AM
2022/08/02,DPH Only,35,15,21,95,51,50,0,0,244066,131425,122872,89077,77222,15711,0,0,11/01/2023 05:43:00 AM,11/01/2023 07:28:13 AM,11/01/2023 08:15:11 AM
2022/08/03,DPH Only,31,23,10,105,57,56,0,0,244097,131448,122882,89182,77279,15767,0,0,11/01/2023 05:43:00 AM,11/01/2023 07:28:13 AM,11/01/2023 08:15:11 AM
2022/08/04,DPH Only,30,21,13,91,53,48,0,0,244127,131469,122895,89273,77332,15815,0,0,11/01/2023 05:43:00 AM,11/01/2023 07:28:13 AM,11/01/2023 08:15:11 AM
2022/08/05,DPH Only,60,41,23,108,50,74,0,0,244187,131510,122918,89381,77382,15889,0,0,11/01/2023 05:43:00 AM,11/01/2023 07:28:13 AM,11/01/2023 08:15:11 AM
2022/08/06,DPH Only,20,9,11,26,17,11,0,0,244207,131519,122929,89407,77399,15900,0,0,11/01/2023 05:43:00 AM,11/01/2023 07:28:13 AM,11/01/2023 08:15:11 AM
2022/08/07,DPH Only,0,0,0,0,0,0,0,0,244207,131519,122929,89407,77399,15900,0,0,11/01/2023 05:43:00 AM,11/01/2023 07:28:13 AM,11/01/2023 08:15:11 AM
2022/08/08,DPH Only,26,19,7,101,58,57,0,0,244233,131538,122936,89508,77457,15957,0,0,11/01/2023 05:43:00 AM,11/01/2023 07:28:13 AM,11/01/2023 08:15:11 AM
2022/08/09,DPH Only,40,19,23,72,50,31,0,0,244273,131557,122959,89580,77507,15988,0,0,11/01/2023 05:43:00 AM,11/01/2023 07:28:13 AM,11/01/2023 08:15:11 AM
2022/08/10,DPH Only,38,25,17,64,32,39,0,0,244311,131582,122976,89644,77539,16027,0,0,11/01/2023 05:43:00 AM,11/01/2023 07:28:13 AM,11/01/2023 08:15:11 AM
2022/08/11,DPH Only,42,29,16,112,70,50,0,0,244353,131611,122992,89756,77609,16077,0,0,11/01/2023 05:43:00 AM,11/01/2023 07:28:13 AM,11/01/2023 08:15:11 AM
2022/08/12,DPH Only,58,36,26,136,92,72,0,0,244411,131647,123018,89892,77701,16149,0,0,11/01/2023 05:43:00 AM,11/01/2023 07:28:13 AM,11/01/2023 08:15:11 AM
2022/08/13,DPH Only,13,7,8,16,8,13,0,0,244424,131654,123026,89908,77709,16162,0,0,11/01/2023 05:43:00 AM,11/01/2023 07:28:13 AM,11/01/2023 08:15:11 AM
2022/08/14,DPH Only,0,0,0,0,0,0,0,0,244424,131654,123026,89908,77709,16162,0,0,11/01/2023 05:43:00 AM,11/01/2023 07:28:13 AM,11/01/2023 08:15:11 AM
2022/08/15,DPH Only,28,15,14,103,66,59,0,0,244452,131669,123040,90011,77775,16221,0,0,11/01/2023 05:43:00 AM,11/01/2023 07:28:13 AM,11/01/2023 08:15:11 AM
2022/08/16,DPH Only,29,22,11,108,58,61,0,0,244481,131691,123051,90119,77833,16282,0,0,11/01/2023 05:43:00 AM,11/01/2023 07:28:13 AM,11/01/2023 08:15:11 AM
2022/08/17,DPH Only,41,27,16,63,36,35,0,0,244522,131718,123067,90182,77869,16317,0,0,11/01/2023 05:43:00 AM,11/01/2023 07:28:13 AM,11/01/2023 08:15:11 AM
2022/08/18,DPH Only,38,27,11,74,40,43,0,0,244560,131745,123078,90256,77909,16360,0,0,11/01/2023 05:43:00 AM,11/01/2023 07:28:13 AM,11/01/2023 08:15:11 AM
2022/08/19,DPH Only,60,35,31,94,46,62,0,0,244620,131780,123109,90350,77955,16422,0,0,11/01/2023 05:43:00 AM,11/01/2023 07:28:13 AM,11/01/2023 08:15:11 AM
2022/08/20,DPH Only,26,12,16,17,13,7,0,0,244646,131792,123125,90367,77968,16429,0,0,11/01/2023 05:43:00 AM,11/01/2023 07:28:13 AM,11/01/2023 08:15:11 AM
2022/08/21,DPH Only,0,0,0,1,1,0,0,0,244646,131792,123125,90368,77969,16429,0,0,11/01/2023 05:43:00 AM,11/01/2023 07:28:13 AM,11/01/2023 08:15:11 AM
2022/08/22,DPH Only,41,22,22,101,56,53,0,0,244687,131814,123147,90469,78025,16482,0,0,11/01/2023 05:43:00 AM,11/01/2023 07:28:13 AM,11/01/2023 08:15:11 AM
2022/08/23,DPH Only,42,28,16,92,58,48,0,0,244729,131842,123163,90561,78083,16530,0,0,11/01/2023 05:43:00 AM,11/01/2023 07:28:13 AM,11/01/2023 08:15:11 AM
2022/08/24,DPH Only,34,22,13,70,40,36,0,0,244763,131864,123176,90631,78123,16566,0,0,11/01/2023 05:43:00 AM,11/01/2023 07:28:13 AM,11/01/2023 08:15:11 AM
2022/08/25,DPH Only,25,15,14,61,36,33,0,0,244788,131879,123190,90692,78159,16599,0,0,11/01/2023 05:43:00 AM,11/01/2023 07:28:13 AM,11/01/2023 08:15:11 AM
2022/08/26,DPH Only,51,27,31,88,56,47,0,0,244839,131906,123221,90780,78215,16646,0,0,11/01/2023 05:43:00 AM,11/01/2023 07:28:13 AM,11/01/2023 08:15:11 AM
2022/08/27,DPH Only,15,9,10,16,15,2,0,0,244854,131915,123231,90796,78230,16648,0,0,11/01/2023 05:43:00 AM,11/01/2023 07:28:13 AM,11/01/2023 08:15:11 AM
2022/08/28,DPH Only,0,0,0,4,4,0,0,0,244854,131915,123231,90800,78234,16648,0,0,11/01/2023 05:43:00 AM,11/01/2023 07:28:13 AM,11/01/2023 08:15:11 AM
2022/08/29,DPH Only,30,15,17,69,33,41,0,0,244884,131930,123248,90869,78267,16689,0,0,11/01/2023 05:43:00 AM,11/01/2023 07:28:13 AM,11/01/2023 08:15:11 AM
2022/08/30,DPH Only,24,13,13,67,41,35,0,0,244908,131943,123261,90936,78308,16724,0,0,11/01/2023 05:43:00 AM,11/01/2023 07:28:13 AM,11/01/2023 08:15:11 AM
2022/08/31,DPH Only,22,14,10,51,30,25,0,0,244930,131957,123271,90987,78338,16749,0,0,11/01/2023 05:43:00 AM,11/01/2023 07:28:13 AM,11/01/2023 08:15:11 AM
2022/09/01,DPH Only,36,22,17,37,27,17,0,0,244966,131979,123288,91024,78365,16766,0,0,11/01/2023 05:43:00 AM,11/01/2023 07:28:13 AM,11/01/2023 08:15:11 AM
2022/09/02,DPH Only,42,27,18,21,19,4,0,0,245008,132006,123306,91045,78384,16770,0,0,11/01/2023 05:43:00 AM,11/01/2023 07:28:13 AM,11/01/2023 08:15:11 AM
2022/09/03,DPH Only,14,6,9,0,0,0,0,0,245022,132012,123315,91045,78384,16770,0,0,11/01/2023 05:43:00 AM,11/01/2023 07:28:13 AM,11/01/2023 08:15:11 AM
2022/09/04,DPH Only,1,1,0,0,0,0,0,0,245023,132013,123315,91045,78384,16770,0,0,11/01/2023 05:43:00 AM,11/01/2023 07:28:13 AM,11/01/2023 08:15:11 AM
2022/09/05,DPH Only,5,1,4,0,0,0,0,0,245028,132014,123319,91045,78384,16770,0,0,11/01/2023 05:43:00 AM,11/01/2023 07:28:13 AM,11/01/2023 08:15:11 AM
2022/09/06,DPH Only,29,12,22,4,4,0,0,0,245057,132026,123341,91049,78388,16770,0,0,11/01/2023 05:43:00 AM,11/01/2023 07:28:13 AM,11/01/2023 08:15:11 AM
2022/09/07,DPH Only,38,18,22,7,7,0,1,1,245095,132044,123363,91056,78395,16770,1,1,11/01/2023 05:43:00 AM,11/01/2023 07:28:13 AM,11/01/2023 08:15:11 AM
2022/09/08,DPH Only,21,12,12,2,2,0,19,19,245116,132056,123375,91058,78397,16770,20,20,11/01/2023 05:43:00 AM,11/01/2023 07:28:13 AM,11/01/2023 08:15:11 AM
2022/09/09,DPH Only,35,14,22,7,6,1,77,77,245151,132070,123397,91065,78403,16771,97,97,11/01/2023 05:43:00 AM,11/01/2023 07:28:13 AM,11/01/2023 08:15:11 AM
2022/09/10,DPH Only,6,2,6,1,1,0,27,27,245157,132072,123403,91066,78404,16771,124,124,11/01/2023 05:43:00 AM,11/01/2023 07:28:13 AM,11/01/2023 08:15:11 AM
2022/09/11,DPH Only,0,0,0,0,0,0,0,0,245157,132072,123403,91066,78404,16771,124,124,11/01/2023 05:43:00 AM,11/01/2023 07:28:13 AM,11/01/2023 08:15:11 AM
2022/09/12,DPH Only,23,14,16,8,8,2,251,251,245180,132086,123419,91074,78412,16773,375,375,11/01/2023 05:43:00 AM,11/01/2023 07:28:13 AM,11/01/2023 08:15:11 AM
2022/09/13,DPH Only,14,8,12,15,13,3,224,224,245194,132094,123431,91089,78425,16776,599,599,11/01/2023 05:43:00 AM,11/01/2023 07:28:13 AM,11/01/2023 08:15:11 AM
2022/09/14,DPH Only,31,13,25,3,3,0,369,369,245225,132107,123456,91092,78428,16776,968,968,11/01/2023 05:43:00 AM,11/01/2023 07:28:13 AM,11/01/2023 08:15:11 AM
2022/09/15,DPH Only,17,14,8,4,4,0,390,390,245242,132121,123464,91096,78432,16776,1358,1358,11/01/2023 05:43:00 AM,11/01/2023 07:28:13 AM,11/01/2023 08:15:11 AM
2022/09/16,DPH Only,33,18,26,8,7,1,597,597,245275,132139,123490,91104,78439,16777,1955,1955,11/01/2023 05:43:00 AM,11/01/2023 07:28:13 AM,11/01/2023 08:15:11 AM
2022/09/17,DPH Only,3,3,3,3,3,1,103,103,245278,132142,123493,91107,78442,16778,2058,2058,11/01/2023 05:43:00 AM,11/01/2023 07:28:13 AM,11/01/2023 08:15:11 AM
2022/09/18,DPH Only,1,0,2,0,0,0,70,70,245279,132142,123495,91107,78442,16778,2128,2128,11/01/2023 05:43:00 AM,11/01/2023 07:28:13 AM,11/01/2023 08:15:11 AM
2022/09/19,DPH Only,20,13,13,10,8,2,346,346,245299,132155,123508,91117,78450,16780,2474,2474,11/01/2023 05:43:00 AM,11/01/2023 07:28:13 AM,11/01/2023 08:15:11 AM
2022/09/20,DPH Only,18,9,11,19,12,6,270,270,245317,132164,123519,91136,78462,16786,2744,2744,11/01/2023 05:43:00 AM,11/01/2023 07:28:13 AM,11/01/2023 08:15:11 AM
2022/09/21,DPH Only,13,9,10,12,8,3,362,362,245330,132173,123529,91148,78470,16789,3106,3106,11/01/2023 05:43:00 AM,11/01/2023 07:28:13 AM,11/01/2023 08:15:11 AM
2022/09/22,DPH Only,25,13,16,15,9,2,277,277,245355,132186,123545,91163,78479,16791,3383,3383,11/01/2023 05:43:00 AM,11/01/2023 07:28:13 AM,11/01/2023 08:15:11 AM
2022/09/23,DPH Only,20,11,16,10,9,1,426,426,245375,132197,123561,91173,78488,16792,3809,3809,11/01/2023 05:43:00 AM,11/01/2023 07:28:13 AM,11/01/2023 08:15:11 AM
2022/09/24,DPH Only,9,4,7,0,0,0,47,47,245384,132201,123568,91173,78488,16792,3856,3856,11/01/2023 05:43:00 AM,11/01/2023 07:28:13 AM,11/01/2023 08:15:11 AM
2022/09/25,DPH Only,0,0,0,1,1,0,0,0,245384,132201,123568,91174,78489,16792,3856,3856,11/01/2023 05:43:00 AM,11/01/2023 07:28:13 AM,11/01/2023 08:15:11 AM
2022/09/26,DPH Only,19,13,15,8,6,2,289,289,245403,132214,123583,91182,78495,16794,4145,4145,11/01/2023 05:43:00 AM,11/01/2023 07:28:13 AM,11/01/2023 08:15:11 AM
2022/09/27,DPH Only,16,13,8,12,8,3,272,272,245419,132227,123591,91194,78503,16797,4417,4417,11/01/2023 05:43:00 AM,11/01/2023 07:28:13 AM,11/01/2023 08:15:11 AM
2022/09/28,DPH Only,18,12,13,8,5,3,309,309,245437,132239,123604,91202,78508,16800,4726,4726,11/01/2023 05:43:00 AM,11/01/2023 07:28:13 AM,11/01/2023 08:15:11 AM
2022/09/29,DPH Only,25,15,14,6,4,1,327,327,245462,132254,123618,91208,78512,16801,5053,5053,11/01/2023 05:43:00 AM,11/01/2023 07:28:13 AM,11/01/2023 08:15:11 AM
2022/09/30,DPH Only,33,19,29,2,2,0,424,424,245495,132273,123647,91210,78514,16801,5477,5477,11/01/2023 05:43:00 AM,11/01/2023 07:28:13 AM,11/01/2023 08:15:11 AM
2022/10/01,DPH Only,11,5,10,1,1,1,119,119,245506,132278,123657,91211,78515,16802,5596,5596,11/01/2023 05:43:00 AM,11/01/2023 07:28:13 AM,11/01/2023 08:15:11 AM
2022/10/02,DPH Only,0,0,0,1,1,0,1,1,245506,132278,123657,91212,78516,16802,5597,5597,11/01/2023 05:43:00 AM,11/01/2023 07:28:13 AM,11/01/2023 08:15:11 AM
2022/10/03,DPH Only,31,18,20,7,4,2,302,302,245537,132296,123677,91219,78520,16804,5899,5899,11/01/2023 05:43:00 AM,11/01/2023 07:28:13 AM,11/01/2023 08:15:11 AM
2022/10/04,DPH Only,30,17,15,2,1,1,325,325,245567,132313,123692,91221,78521,16805,6224,6224,11/01/2023 05:43:00 AM,11/01/2023 07:28:13 AM,11/01/2023 08:15:11 AM
2022/10/05,DPH Only,23,16,14,6,4,1,288,288,245590,132329,123706,91227,78525,16806,6512,6512,11/01/2023 05:43:00 AM,11/01/2023 07:28:13 AM,11/01/2023 08:15:11 AM
2022/10/06,DPH Only,15,8,14,6,6,1,317,317,245605,132337,123720,91233,78531,16807,6829,6829,11/01/2023 05:43:00 AM,11/01/2023 07:28:13 AM,11/01/2023 08:15:11 AM
2022/10/07,DPH Only,24,9,22,4,4,2,492,492,245629,132346,123742,91237,78535,16809,7321,7321,11/01/2023 05:43:00 AM,11/01/2023 07:28:13 AM,11/01/2023 08:15:11 AM
2022/10/08,DPH Only,3,0,6,2,0,1,87,87,245632,132346,123748,91239,78535,16810,7408,7408,11/01/2023 05:43:00 AM,11/01/2023 07:28:13 AM,11/01/2023 08:15:11 AM
2022/10/09,DPH Only,0,0,0,0,0,0,1,1,245632,132346,123748,91239,78535,16810,7409,7409,11/01/2023 05:43:00 AM,11/01/2023 07:28:13 AM,11/01/2023 08:15:11 AM
2022/10/10,DPH Only,7,3,5,1,1,0,151,151,245639,132349,123753,91240,78536,16810,7560,7560,11/01/2023 05:43:00 AM,11/01/2023 07:28:13 AM,11/01/2023 08:15:11 AM
2022/10/11,DPH Only,11,9,5,5,4,3,339,339,245650,132358,123758,91245,78540,16813,7899,7899,11/01/2023 05:43:00 AM,11/01/2023 07:28:13 AM,11/01/2023 08:15:11 AM
2022/10/12,DPH Only,26,14,16,10,9,1,363,363,245676,132372,123774,91255,78549,16814,8262,8262,11/01/2023 05:43:00 AM,11/01/2023 07:28:13 AM,11/01/2023 08:15:11 AM
2022/10/13,DPH Only,17,11,10,7,7,0,379,378,245693,132383,123784,91262,78556,16814,8641,8640,11/01/2023 05:43:00 AM,11/01/2023 07:28:13 AM,11/01/2023 08:15:11 AM
2022/10/14,DPH Only,33,18,28,5,4,0,488,488,245726,132401,123812,91267,78560,16814,9129,9128,11/01/2023 05:43:00 AM,11/01/2023 07:28:13 AM,11/01/2023 08:15:11 AM
2022/10/15,DPH Only,7,4,5,1,1,0,132,132,245733,132405,123817,91268,78561,16814,9261,9260,11/01/2023 05:43:00 AM,11/01/2023 07:28:13 AM,11/01/2023 08:15:11 AM
2022/10/16,DPH Only,0,0,0,0,0,0,3,3,245733,132405,123817,91268,78561,16814,9264,9263,11/01/2023 05:43:00 AM,11/01/2023 07:28:13 AM,11/01/2023 08:15:11 AM
2022/10/17,DPH Only,13,6,10,4,2,2,376,376,245746,132411,123827,91272,78563,16816,9640,9639,11/01/2023 05:43:00 AM,11/01/2023 07:28:13 AM,11/01/2023 08:15:11 AM
2022/10/18,DPH Only,11,8,10,3,2,1,365,365,245757,132419,123837,91275,78565,16817,10005,10004,11/01/2023 05:43:00 AM,11/01/2023 07:28:13 AM,11/01/2023 08:15:11 AM
2022/10/19,DPH Only,13,9,7,0,0,0,337,337,245770,132428,123844,91275,78565,16817,10342,10341,11/01/2023 05:43:00 AM,11/01/2023 07:28:13 AM,11/01/2023 08:15:11 AM
2022/10/20,DPH Only,9,7,7,3,2,1,340,340,245779,132435,123851,91278,78567,16818,10682,10681,11/01/2023 05:43:00 AM,11/01/2023 07:28:13 AM,11/01/2023 08:15:11 AM
2022/10/21,DPH Only,30,20,20,0,0,0,512,512,245809,132455,123871,91278,78567,16818,11194,11193,11/01/2023 05:43:00 AM,11/01/2023 07:28:13 AM,11/01/2023 08:15:11 AM
2022/10/22,DPH Only,3,2,2,1,0,0,104,104,245812,132457,123873,91279,78567,16818,11298,11297,11/01/2023 05:43:00 AM,11/01/2023 07:28:13 AM,11/01/2023 08:15:11 AM
2022/10/23,DPH Only,1,0,1,0,0,0,2,2,245813,132457,123874,91279,78567,16818,11300,11299,11/01/2023 05:43:00 AM,11/01/2023 07:28:13 AM,11/01/2023 08:15:11 AM
2022/10/24,DPH Only,27,12,25,4,1,1,372,372,245840,132469,123899,91283,78568,16819,11672,11671,11/01/2023 05:43:00 AM,11/01/2023 07:28:13 AM,11/01/2023 08:15:11 AM
2022/10/25,DPH Only,26,20,11,4,2,2,289,289,245866,132489,123910,91287,78570,16821,11961,11960,11/01/2023 05:43:00 AM,11/01/2023 07:28:13 AM,11/01/2023 08:15:11 AM
2022/10/26,DPH Only,19,16,6,6,3,4,336,336,245885,132505,123916,91293,78573,16825,12297,12296,11/01/2023 05:43:00 AM,11/01/2023 07:28:13 AM,11/01/2023 08:15:11 AM
2022/10/27,DPH Only,28,20,17,8,4,3,415,415,245913,132525,123933,91301,78577,16828,12712,12711,11/01/2023 05:43:00 AM,11/01/2023 07:28:13 AM,11/01/2023 08:15:11 AM
2022/10/28,DPH Only,25,16,20,3,1,0,523,523,245938,132541,123953,91304,78578,16828,13235,13234,11/01/2023 05:43:00 AM,11/01/2023 07:28:13 AM,11/01/2023 08:15:11 AM
2022/10/29,DPH Only,4,3,2,1,1,0,65,65,245942,132544,123955,91305,78579,16828,13300,13299,11/01/2023 05:43:00 AM,11/01/2023 07:28:13 AM,11/01/2023 08:15:11 AM
2022/10/30,DPH Only,1,1,0,0,0,0,3,3,245943,132545,123955,91305,78579,16828,13303,13302,11/01/2023 05:43:00 AM,11/01/2023 07:28:13 AM,11/01/2023 08:15:11 AM
2022/10/31,DPH Only,17,9,18,1,0,0,307,307,245960,132554,123973,91306,78579,16828,13610,13609,11/01/2023 05:43:00 AM,11/01/2023 07:28:13 AM,11/01/2023 08:15:11 AM
2022/11/01,DPH Only,14,9,8,6,3,3,239,239,245974,132563,123981,91312,78582,16831,13849,13848,11/01/2023 05:43:00 AM,11/01/2023 07:28:13 AM,11/01/2023 08:15:11 AM
2022/11/02,DPH Only,23,16,14,4,2,3,336,336,245997,132579,123995,91316,78584,16834,14185,14184,11/01/2023 05:43:00 AM,11/01/2023 07:28:13 AM,11/01/2023 08:15:11 AM
2022/11/03,DPH Only,30,19,15,3,2,1,347,347,246027,132598,124010,91319,78586,16835,14532,14531,11/01/2023 05:43:00 AM,11/01/2023 07:28:13 AM,11/01/2023 08:15:11 AM
2022/11/04,DPH Only,21,15,13,7,3,1,441,440,246048,132613,124023,91326,78589,16836,14973,14971,11/01/2023 05:43:00 AM,11/01/2023 07:28:13 AM,11/01/2023 08:15:11 AM
2022/11/05,DPH Only,3,1,2,0,0,0,107,107,246051,132614,124025,91326,78589,16836,15080,15078,11/01/2023 05:43:00 AM,11/01/2023 07:28:13 AM,11/01/2023 08:15:11 AM
2022/11/06,DPH Only,1,1,0,0,0,0,1,1,246052,132615,124025,91326,78589,16836,15081,15079,11/01/2023 05:43:00 AM,11/01/2023 07:28:13 AM,11/01/2023 08:15:11 AM
2022/11/07,DPH Only,28,19,18,4,1,0,333,332,246080,132634,124043,91330,78590,16836,15414,15411,11/01/2023 05:43:00 AM,11/01/2023 07:28:13 AM,11/01/2023 08:15:11 AM
2022/11/08,DPH Only,20,13,9,4,0,1,269,269,246100,132647,124052,91334,78590,16837,15683,15680,11/01/2023 05:43:00 AM,11/01/2023 07:28:13 AM,11/01/2023 08:15:11 AM
2022/11/09,DPH Only,18,13,8,2,1,1,350,350,246118,132660,124060,91336,78591,16838,16033,16030,11/01/2023 05:43:00 AM,11/01/2023 07:28:13 AM,11/01/2023 08:15:11 AM
2022/11/10,DPH Only,19,15,11,2,2,1,324,324,246137,132675,124071,91338,78593,16839,16357,16354,11/01/2023 05:43:00 AM,11/01/2023 07:28:13 AM,11/01/2023 08:15:11 AM
2022/11/11,DPH Only,4,2,4,0,0,0,138,138,246141,132677,124075,91338,78593,16839,16495,16492,11/01/2023 05:43:00 AM,11/01/2023 07:28:13 AM,11/01/2023 08:15:11 AM
2022/11/12,DPH Only,4,2,6,1,1,1,44,44,246145,132679,124081,91339,78594,16840,16539,16536,11/01/2023 05:43:00 AM,11/01/2023 07:28:13 AM,11/01/2023 08:15:11 AM
2022/11/13,DPH Only,1,1,0,0,0,0,1,1,246146,132680,124081,91339,78594,16840,16540,16537,11/01/2023 05:43:00 AM,11/01/2023 07:28:13 AM,11/01/2023 08:15:11 AM
2022/11/14,DPH Only,17,12,12,1,0,0,345,345,246163,132692,124093,91340,78594,16840,16885,16882,11/01/2023 05:43:00 AM,11/01/2023 07:28:13 AM,11/01/2023 08:15:11 AM
2022/11/15,DPH Only,28,16,14,4,1,2,276,275,246191,132708,124107,91344,78595,16842,17161,17157,11/01/2023 05:43:00 AM,11/01/2023 07:28:13 AM,11/01/2023 08:15:11 AM
2022/11/16,DPH Only,18,11,14,6,2,4,412,412,246209,132719,124121,91350,78597,16846,17573,17569,11/01/2023 05:43:00 AM,11/01/2023 07:28:13 AM,11/01/2023 08:15:11 AM
2022/11/17,DPH Only,29,20,14,5,1,0,300,299,246238,132739,124135,91355,78598,16846,17873,17868,11/01/2023 05:43:00 AM,11/01/2023 07:28:13 AM,11/01/2023 08:15:11 AM
2022/11/18,DPH Only,26,16,22,1,1,1,487,487,246264,132755,124157,91356,78599,16847,18360,18355,11/01/2023 05:43:00 AM,11/01/2023 07:28:13 AM,11/01/2023 08:15:11 AM
2022/11/19,DPH Only,3,3,5,2,1,1,120,119,246267,132758,124162,91358,78600,16848,18480,18474,11/01/2023 05:43:00 AM,11/01/2023 07:28:13 AM,11/01/2023 08:15:11 AM
2022/11/20,DPH Only,0,0,0,1,1,1,1,1,246267,132758,124162,91359,78601,16849,18481,18475,11/01/2023 05:43:00 AM,11/01/2023 07:28:13 AM,11/01/2023 08:15:11 AM
2022/11/21,DPH Only,25,17,12,2,1,1,276,275,246292,132775,124174,91361,78602,16850,18757,18750,11/01/2023 05:43:00 AM,11/01/2023 07:28:13 AM,11/01/2023 08:15:11 AM
2022/11/22,DPH Only,23,16,11,4,3,1,299,299,246315,132791,124185,91365,78605,16851,19056,19049,11/01/2023 05:43:00 AM,11/01/2023 07:28:13 AM,11/01/2023 08:15:11 AM
2022/11/23,DPH Only,18,12,10,0,0,0,277,277,246333,132803,124195,91365,78605,16851,19333,19326,11/01/2023 05:43:00 AM,11/01/2023 07:28:13 AM,11/01/2023 08:15:11 AM
2022/11/24,DPH Only,0,0,0,0,0,0,0,0,246333,132803,124195,91365,78605,16851,19333,19326,11/01/2023 05:43:00 AM,11/01/2023 07:28:13 AM,11/01/2023 08:15:11 AM
2022/11/25,DPH Only,0,0,0,0,0,0,0,0,246333,132803,124195,91365,78605,16851,19333,19326,11/01/2023 05:43:00 AM,11/01/2023 07:28:13 AM,11/01/2023 08:15:11 AM
2022/11/26,DPH Only,7,3,6,1,0,0,58,58,246340,132806,124201,91366,78605,16851,19391,19384,11/01/2023 05:43:00 AM,11/01/2023 07:28:13 AM,11/01/2023 08:15:11 AM
2022/11/27,DPH Only,0,0,0,0,0,0,0,0,246340,132806,124201,91366,78605,16851,19391,19384,11/01/2023 05:43:00 AM,11/01/2023 07:28:13 AM,11/01/2023 08:15:11 AM
2022/11/28,DPH Only,20,14,14,1,0,1,252,252,246360,132820,124215,91367,78605,16852,19643,19636,11/01/2023 05:43:00 AM,11/01/2023 07:28:13 AM,11/01/2023 08:15:11 AM
2022/11/29,DPH Only,24,18,10,5,4,2,254,254,246384,132838,124225,91372,78609,16854,19897,19890,11/01/2023 05:43:00 AM,11/01/2023 07:28:13 AM,11/01/2023 08:15:11 AM
2022/11/30,DPH Only,26,21,12,4,2,2,245,245,246410,132859,124237,91376,78611,16856,20142,20135,11/01/2023 05:43:00 AM,11/01/2023 07:28:13 AM,11/01/2023 08:15:11 AM
2022/12/01,DPH Only,14,9,8,4,2,2,220,219,246424,132868,124245,91380,78613,16858,20362,20354,11/01/2023 05:43:00 AM,11/01/2023 07:28:13 AM,11/01/2023 08:15:11 AM
2022/12/02,DPH Only,21,16,11,1,1,0,284,282,246445,132884,124256,91381,78614,16858,20646,20636,11/01/2023 05:43:00 AM,11/01/2023 07:28:13 AM,11/01/2023 08:15:11 AM
2022/12/03,DPH Only,4,1,3,3,2,1,50,50,246449,132885,124259,91384,78616,16859,20696,20686,11/01/2023 05:43:00 AM,11/01/2023 07:28:13 AM,11/01/2023 08:15:11 AM
2022/12/04,DPH Only,0,0,0,0,0,0,2,2,246449,132885,124259,91384,78616,16859,20698,20688,11/01/2023 05:43:00 AM,11/01/2023 07:28:13 AM,11/01/2023 08:15:11 AM
2022/12/05,DPH Only,18,10,9,1,1,0,235,235,246467,132895,124268,91385,78617,16859,20933,20923,11/01/2023 05:43:00 AM,11/01/2023 07:28:13 AM,11/01/2023 08:15:11 AM
2022/12/06,DPH Only,13,6,13,5,3,0,223,223,246480,132901,124281,91390,78620,16859,21156,21146,11/01/2023 05:43:00 AM,11/01/2023 07:28:13 AM,11/01/2023 08:15:11 AM
2022/12/07,DPH Only,36,24,18,1,1,0,248,248,246516,132925,124299,91391,78621,16859,21404,21394,11/01/2023 05:43:00 AM,11/01/2023 07:28:13 AM,11/01/2023 08:15:11 AM
2022/12/08,DPH Only,23,17,12,4,2,3,266,266,246539,132942,124311,91395,78623,16862,21670,21660,11/01/2023 05:43:00 AM,11/01/2023 07:28:13 AM,11/01/2023 08:15:11 AM
2022/12/09,DPH Only,30,20,18,0,0,0,288,287,246569,132962,124329,91395,78623,16862,21958,21947,11/01/2023 05:43:00 AM,11/01/2023 07:28:13 AM,11/01/2023 08:15:11 AM
2022/12/10,DPH Only,0,0,0,0,0,0,0,0,246569,132962,124329,91395,78623,16862,21958,21947,11/01/2023 05:43:00 AM,11/01/2023 07:28:13 AM,11/01/2023 08:15:11 AM
2022/12/11,DPH Only,0,0,0,0,0,0,0,0,246569,132962,124329,91395,78623,16862,21958,21947,11/01/2023 05:43:00 AM,11/01/2023 07:28:13 AM,11/01/2023 08:15:11 AM
2022/12/12,DPH Only,20,15,9,0,0,0,228,228,246589,132977,124338,91395,78623,16862,22186,22175,11/01/2023 05:43:00 AM,11/01/2023 07:28:13 AM,11/01/2023 08:15:11 AM
2022/12/13,DPH Only,13,9,6,3,2,0,183,183,246602,132986,124344,91398,78625,16862,22369,22358,11/01/2023 05:43:00 AM,11/01/2023 07:28:13 AM,11/01/2023 08:15:11 AM
2022/12/14,DPH Only,33,21,17,0,0,0,212,211,246635,133007,124361,91398,78625,16862,22581,22569,11/01/2023 05:43:00 AM,11/01/2023 07:28:13 AM,11/01/2023 08:15:11 AM
2022/12/15,DPH Only,31,20,13,4,2,2,267,267,246666,133027,124374,91402,78627,16864,22848,22836,11/01/2023 05:43:00 AM,11/01/2023 07:28:13 AM,11/01/2023 08:15:11 AM
2022/12/16,DPH Only,18,11,11,1,1,0,264,263,246684,133038,124385,91403,78628,16864,23112,23099,11/01/2023 05:43:00 AM,11/01/2023 07:28:13 AM,11/01/2023 08:15:11 AM
2022/12/17,DPH Only,2,2,2,0,0,0,88,88,246686,133040,124387,91403,78628,16864,23200,23187,11/01/2023 05:43:00 AM,11/01/2023 07:28:13 AM,11/01/2023 08:15:11 AM
2022/12/18,DPH Only,1,1,0,0,0,0,0,0,246687,133041,124387,91403,78628,16864,23200,23187,11/01/2023 05:43:00 AM,11/01/2023 07:28:13 AM,11/01/2023 08:15:11 AM
2022/12/19,DPH Only,35,15,24,3,2,1,274,274,246722,133056,124411,91406,78630,16865,23474,23461,11/01/2023 05:43:00 AM,11/01/2023 07:28:13 AM,11/01/2023 08:15:11 AM
2022/12/20,DPH Only,16,12,9,0,0,0,189,189,246738,133068,124420,91406,78630,16865,23663,23650,11/01/2023 05:43:00 AM,11/01/2023 07:28:13 AM,11/01/2023 08:15:11 AM
2022/12/21,DPH Only,22,18,5,3,1,1,184,184,246760,133086,124425,91409,78631,16866,23847,23834,11/01/2023 05:43:00 AM,11/01/2023 07:28:13 AM,11/01/2023 08:15:11 AM
2022/12/22,DPH Only,16,9,9,1,0,1,168,168,246776,133095,124434,91410,78631,16867,24015,24002,11/01/2023 05:43:00 AM,11/01/2023 07:28:13 AM,11/01/2023 08:15:11 AM
2022/12/23,DPH Only,21,16,8,0,0,0,178,177,246797,133111,124442,91410,78631,16867,24193,24179,11/01/2023 05:43:00 AM,11/01/2023 07:28:13 AM,11/01/2023 08:15:11 AM
2022/12/24,DPH Only,0,0,0,1,0,1,1,1,246797,133111,124442,91411,78631,16868,24194,24180,11/01/2023 05:43:00 AM,11/01/2023 07:28:13 AM,11/01/2023 08:15:11 AM
2022/12/25,DPH Only,0,0,0,0,0,0,0,0,246797,133111,124442,91411,78631,16868,24194,24180,11/01/2023 05:43:00 AM,11/01/2023 07:28:13 AM,11/01/2023 08:15:11 AM
2022/12/26,DPH Only,0,0,0,0,0,0,0,0,246797,133111,124442,91411,78631,16868,24194,24180,11/01/2023 05:43:00 AM,11/01/2023 07:28:13 AM,11/01/2023 08:15:10 AM
2022/12/27,DPH Only,18,11,10,1,1,0,141,141,246815,133122,124452,91412,78632,16868,24335,24321,11/01/2023 05:43:00 AM,11/01/2023 07:28:13 AM,11/01/2023 08:15:10 AM
2022/12/28,DPH Only,16,10,11,1,1,0,144,144,246831,133132,124463,91413,78633,16868,24479,24465,11/01/2023 05:43:00 AM,11/01/2023 07:28:13 AM,11/01/2023 08:15:10 AM
2022/12/29,DPH Only,19,7,13,1,0,1,148,148,246850,133139,124476,91414,78633,16869,24627,24613,11/01/2023 05:43:00 AM,11/01/2023 07:28:13 AM,11/01/2023 08:15:10 AM
2022/12/30,DPH Only,14,7,9,0,0,0,96,96,246864,133146,124485,91414,78633,16869,24723,24709,11/01/2023 05:43:00 AM,11/01/2023 07:28:13 AM,11/01/2023 08:15:10 AM
2022/12/31,DPH Only,0,0,0,0,0,0,0,0,246864,133146,124485,91414,78633,16869,24723,24709,11/01/2023 05:43:00 AM,11/01/2023 07:28:13 AM,11/01/2023 08:15:10 AM
2023/01/01,DPH Only,0,0,0,1,1,1,1,1,246864,133146,124485,91415,78634,16870,24724,24710,11/01/2023 05:43:00 AM,11/01/2023 07:28:13 AM,11/01/2023 08:15:10 AM
2023/01/02,DPH Only,0,0,0,1,1,1,0,0,246864,133146,124485,91416,78635,16871,24724,24710,11/01/2023 05:43:00 AM,11/01/2023 07:28:13 AM,11/01/2023 08:15:10 AM
2023/01/03,DPH Only,23,14,15,0,0,0,127,127,246887,133160,124500,91416,78635,16871,24851,24837,11/01/2023 05:43:00 AM,11/01/2023 07:28:13 AM,11/01/2023 08:15:10 AM
2023/01/04,DPH Only,12,7,6,0,0,0,121,120,246899,133167,124506,91416,78635,16871,24972,24957,11/01/2023 05:43:00 AM,11/01/2023 07:28:13 AM,11/01/2023 08:15:10 AM
2023/01/05,DPH Only,17,8,10,1,1,1,110,109,246916,133175,124516,91417,78636,16872,25082,25066,11/01/2023 05:43:00 AM,11/01/2023 07:28:13 AM,11/01/2023 08:15:10 AM
2023/01/06,DPH Only,24,13,16,1,1,0,170,170,246940,133188,124532,91418,78637,16872,25252,25236,11/01/2023 05:43:00 AM,11/01/2023 07:28:13 AM,11/01/2023 08:15:10 AM
2023/01/07,DPH Only,7,5,3,1,0,1,31,31,246947,133193,124535,91419,78637,16873,25283,25267,11/01/2023 05:43:00 AM,11/01/2023 07:28:13 AM,11/01/2023 08:15:10 AM
2023/01/08,DPH Only,0,0,0,0,0,0,0,0,246947,133193,124535,91419,78637,16873,25283,25267,11/01/2023 05:43:00 AM,11/01/2023 07:28:13 AM,11/01/2023 08:15:10 AM
2023/01/09,DPH Only,19,9,11,4,3,1,142,142,246966,133202,124546,91423,78640,16874,25425,25409,11/01/2023 05:43:00 AM,11/01/2023 07:28:13 AM,11/01/2023 08:15:10 AM
2023/01/10,DPH Only,13,8,7,2,0,2,105,104,246979,133210,124553,91425,78640,16876,25530,25513,11/01/2023 05:43:00 AM,11/01/2023 07:28:13 AM,11/01/2023 08:15:10 AM
2023/01/11,DPH Only,25,18,10,0,0,0,132,130,247004,133228,124563,91425,78640,16876,25662,25643,11/01/2023 05:43:00 AM,11/01/2023 07:28:13 AM,11/01/2023 08:15:10 AM
2023/01/12,DPH Only,19,8,12,4,1,1,142,141,247023,133236,124575,91429,78641,16877,25804,25784,11/01/2023 05:43:00 AM,11/01/2023 07:28:13 AM,11/01/2023 08:15:10 AM
2023/01/13,DPH Only,14,11,4,0,0,0,123,122,247037,133247,124579,91429,78641,16877,25927,25906,11/01/2023 05:43:00 AM,11/01/2023 07:28:13 AM,11/01/2023 08:15:10 AM
2023/01/14,DPH Only,1,1,2,0,0,0,18,18,247038,133248,124581,91429,78641,16877,25945,25924,11/01/2023 05:43:00 AM,11/01/2023 07:28:13 AM,11/01/2023 08:15:10 AM
2023/01/15,DPH Only,0,0,1,0,0,0,1,1,247038,133248,124582,91429,78641,16877,25946,25925,11/01/2023 05:43:00 AM,11/01/2023 07:28:13 AM,11/01/2023 08:15:10 AM
2023/01/16,DPH Only,2,2,1,0,0,0,13,13,247040,133250,124583,91429,78641,16877,25959,25938,11/01/2023 05:43:00 AM,11/01/2023 07:28:13 AM,11/01/2023 08:15:10 AM
2023/01/17,DPH Only,17,10,13,1,1,1,118,116,247057,133260,124596,91430,78642,16878,26077,26054,11/01/2023 05:43:00 AM,11/01/2023 07:28:13 AM,11/01/2023 08:15:10 AM
2023/01/18,DPH Only,26,15,13,2,2,0,152,151,247083,133275,124609,91432,78644,16878,26229,26205,11/01/2023 05:43:00 AM,11/01/2023 07:28:13 AM,11/01/2023 08:15:10 AM
2023/01/19,DPH Only,23,13,17,0,0,0,110,109,247106,133288,124626,91432,78644,16878,26339,26314,11/01/2023 05:43:00 AM,11/01/2023 07:28:13 AM,11/01/2023 08:15:10 AM
2023/01/20,DPH Only,29,17,17,0,0,0,115,114,247135,133305,124643,91432,78644,16878,26454,26428,11/01/2023 05:43:00 AM,11/01/2023 07:28:13 AM,11/01/2023 08:15:10 AM
2023/01/21,DPH Only,1,1,0,0,0,0,16,16,247136,133306,124643,91432,78644,16878,26470,26444,11/01/2023 05:43:00 AM,11/01/2023 07:28:13 AM,11/01/2023 08:15:10 AM
2023/01/22,DPH Only,0,0,0,0,0,0,0,0,247136,133306,124643,91432,78644,16878,26470,26444,11/01/2023 05:43:00 AM,11/01/2023 07:28:13 AM,11/01/2023 08:15:10 AM
2023/01/23,DPH Only,15,9,9,0,0,0,90,90,247151,133315,124652,91432,78644,16878,26560,26534,11/01/2023 05:43:00 AM,11/01/2023 07:28:13 AM,11/01/2023 08:15:10 AM
2023/01/24,DPH Only,16,8,12,0,0,0,91,91,247167,133323,124664,91432,78644,16878,26651,26625,11/01/2023 05:43:00 AM,11/01/2023 07:28:13 AM,11/01/2023 08:15:10 AM
2023/01/25,DPH Only,18,11,11,2,0,1,157,157,247185,133334,124675,91434,78644,16879,26808,26782,11/01/2023 05:43:00 AM,11/01/2023 07:28:13 AM,11/01/2023 08:15:10 AM
2023/01/26,DPH Only,25,10,18,2,1,0,119,118,247210,133344,124693,91436,78645,16879,26927,26900,11/01/2023 05:43:00 AM,11/01/2023 07:28:13 AM,11/01/2023 08:15:10 AM
2023/01/27,DPH Only,25,17,14,1,0,0,120,119,247235,133361,124707,91437,78645,16879,27047,27019,11/01/2023 05:43:00 AM,11/01/2023 07:28:13 AM,11/01/2023 08:15:10 AM
2023/01/28,DPH Only,0,0,1,0,0,0,13,13,247235,133361,124708,91437,78645,16879,27060,27032,11/01/2023 05:43:00 AM,11/01/2023 07:28:13 AM,11/01/2023 08:15:10 AM
2023/01/29,DPH Only,0,0,0,0,0,0,1,1,247235,133361,124708,91437,78645,16879,27061,27033,11/01/2023 05:43:00 AM,11/01/2023 07:28:13 AM,11/01/2023 08:15:10 AM
2023/01/30,DPH Only,13,7,9,2,0,0,110,109,247248,133368,124717,91439,78645,16879,27171,27142,11/01/2023 05:43:00 AM,11/01/2023 07:28:13 AM,11/01/2023 08:15:10 AM
2023/01/31,DPH Only,18,16,8,1,1,1,110,109,247266,133384,124725,91440,78646,16880,27281,27251,11/01/2023 05:43:00 AM,11/01/2023 07:28:13 AM,11/01/2023 08:15:10 AM
2023/02/01,DPH Only,15,8,10,1,1,0,99,99,247281,133392,124735,91441,78647,16880,27380,27350,11/01/2023 05:43:00 AM,11/01/2023 07:28:13 AM,11/01/2023 08:15:10 AM
2023/02/02,DPH Only,12,7,6,0,0,0,68,68,247293,133399,124741,91441,78647,16880,27448,27418,11/01/2023 05:43:00 AM,11/01/2023 07:28:13 AM,11/01/2023 08:15:10 AM
2023/02/03,DPH Only,16,8,11,0,0,0,86,86,247309,133407,124752,91441,78647,16880,27534,27504,11/01/2023 05:43:00 AM,11/01/2023 07:28:13 AM,11/01/2023 08:15:10 AM
2023/02/04,DPH Only,0,0,0,0,0,0,0,0,247309,133407,124752,91441,78647,16880,27534,27504,11/01/2023 05:43:00 AM,11/01/2023 07:28:13 AM,11/01/2023 08:15:10 AM
2023/02/05,DPH Only,0,0,0,0,0,0,0,0,247309,133407,124752,91441,78647,16880,27534,27504,11/01/2023 05:43:00 AM,11/01/2023 07:28:13 AM,11/01/2023 08:15:10 AM
2023/02/06,DPH Only,14,7,10,0,0,0,81,81,247323,133414,124762,91441,78647,16880,27615,27585,11/01/2023 05:43:00 AM,11/01/2023 07:28:13 AM,11/01/2023 08:15:10 AM
2023/02/07,DPH Only,14,10,7,1,1,0,89,89,247337,133424,124769,91442,78648,16880,27704,27674,11/01/2023 05:43:00 AM,11/01/2023 07:28:13 AM,11/01/2023 08:15:10 AM
2023/02/08,DPH Only,14,9,6,0,0,0,108,108,247351,133433,124775,91442,78648,16880,27812,27782,11/01/2023 05:43:00 AM,11/01/2023 07:28:13 AM,11/01/2023 08:15:10 AM
2023/02/09,DPH Only,20,13,9,2,2,1,69,69,247371,133446,124784,91444,78650,16881,27881,27851,11/01/2023 05:43:00 AM,11/01/2023 07:28:13 AM,11/01/2023 08:15:10 AM
2023/02/10,DPH Only,20,11,11,1,1,1,82,82,247391,133457,124795,91445,78651,16882,27963,27933,11/01/2023 05:43:00 AM,11/01/2023 07:28:13 AM,11/01/2023 08:15:10 AM
2023/02/11,DPH Only,0,0,0,0,0,0,4,4,247391,133457,124795,91445,78651,16882,27967,27937,11/01/2023 05:43:00 AM,11/01/2023 07:28:13 AM,11/01/2023 08:15:10 AM
2023/02/12,DPH Only,0,0,0,0,0,0,0,0,247391,133457,124795,91445,78651,16882,27967,27937,11/01/2023 05:43:00 AM,11/01/2023 07:28:13 AM,11/01/2023 08:15:10 AM
2023/02/13,DPH Only,23,15,8,0,0,0,84,84,247414,133472,124803,91445,78651,16882,28051,28021,11/01/2023 05:43:00 AM,11/01/2023 07:28:13 AM,11/01/2023 08:15:10 AM
2023/02/14,DPH Only,18,12,11,1,1,0,73,73,247432,133484,124814,91446,78652,16882,28124,28094,11/01/2023 05:43:00 AM,11/01/2023 07:28:13 AM,11/01/2023 08:15:10 AM
2023/02/15,DPH Only,15,10,9,0,0,0,95,95,247447,133494,124823,91446,78652,16882,28219,28189,11/01/2023 05:43:00 AM,11/01/2023 07:28:13 AM,11/01/2023 08:15:10 AM
2023/02/16,DPH Only,14,4,11,1,1,0,77,77,247461,133498,124834,91447,78653,16882,28296,28266,11/01/2023 05:43:00 AM,11/01/2023 07:28:13 AM,11/01/2023 08:15:10 AM
2023/02/17,DPH Only,21,10,12,0,0,0,81,80,247482,133508,124846,91447,78653,16882,28377,28346,11/01/2023 05:43:00 AM,11/01/2023 07:28:13 AM,11/01/2023 08:15:10 AM
2023/02/18,DPH Only,0,0,0,0,0,0,2,2,247482,133508,124846,91447,78653,16882,28379,28348,11/01/2023 05:43:00 AM,11/01/2023 07:28:13 AM,11/01/2023 08:15:10 AM
2023/02/19,DPH Only,0,0,0,0,0,0,0,0,247482,133508,124846,91447,78653,16882,28379,28348,11/01/2023 05:43:00 AM,11/01/2023 07:28:13 AM,11/01/2023 08:15:10 AM
2023/02/20,DPH Only,1,1,0,0,0,0,7,7,247483,133509,124846,91447,78653,16882,28386,28355,11/01/2023 05:43:00 AM,11/01/2023 07:28:13 AM,11/01/2023 08:15:10 AM
2023/02/21,DPH Only,14,9,7,0,0,0,81,81,247497,133518,124853,91447,78653,16882,28467,28436,11/01/2023 05:43:00 AM,11/01/2023 07:28:13 AM,11/01/2023 08:15:10 AM
2023/02/22,DPH Only,13,11,7,0,0,0,78,78,247510,133529,124860,91447,78653,16882,28545,28514,11/01/2023 05:43:00 AM,11/01/2023 07:28:13 AM,11/01/2023 08:15:10 AM
2023/02/23,DPH Only,16,11,6,2,2,1,75,74,247526,133540,124866,91449,78655,16883,28620,28588,11/01/2023 05:43:00 AM,11/01/2023 07:28:13 AM,11/01/2023 08:15:10 AM
2023/02/24,DPH Only,19,11,11,0,0,0,70,70,247545,133551,124877,91449,78655,16883,28690,28658,11/01/2023 05:43:00 AM,11/01/2023 07:28:13 AM,11/01/2023 08:15:10 AM
2023/02/25,DPH Only,1,0,1,1,0,1,3,3,247546,133551,124878,91450,78655,16884,28693,28661,11/01/2023 05:43:00 AM,11/01/2023 07:28:13 AM,11/01/2023 08:15:10 AM
2023/02/26,DPH Only,0,0,0,0,0,0,0,0,247546,133551,124878,91450,78655,16884,28693,28661,11/01/2023 05:43:00 AM,11/01/2023 07:28:13 AM,11/01/2023 08:15:10 AM
2023/02/27,DPH Only,13,6,8,1,0,1,66,66,247559,133557,124886,91451,78655,16885,28759,28727,11/01/2023 05:43:00 AM,11/01/2023 07:28:13 AM,11/01/2023 08:15:10 AM
2023/02/28,DPH Only,7,3,6,1,1,0,63,63,247566,133560,124892,91452,78656,16885,28822,28790,11/01/2023 05:43:00 AM,11/01/2023 07:28:13 AM,11/01/2023 08:15:10 AM
2023/03/01,DPH Only,22,13,12,0,0,0,73,73,247588,133573,124904,91452,78656,16885,28895,28863,11/01/2023 05:43:00 AM,11/01/2023 07:28:13 AM,11/01/2023 08:15:10 AM
2023/03/02,DPH Only,18,12,8,0,0,0,57,57,247606,133585,124912,91452,78656,16885,28952,28920,11/01/2023 05:43:00 AM,11/01/2023 07:28:13 AM,11/01/2023 08:15:10 AM
2023/03/03,DPH Only,14,8,8,0,0,0,68,68,247620,133593,124920,91452,78656,16885,29020,28988,11/01/2023 05:43:00 AM,11/01/2023 07:28:13 AM,11/01/2023 08:15:10 AM
2023/03/04,DPH Only,0,0,0,0,0,0,1,1,247620,133593,124920,91452,78656,16885,29021,28989,11/01/2023 05:43:00 AM,11/01/2023 07:28:13 AM,11/01/2023 08:15:10 AM
2023/03/05,DPH Only,0,0,0,1,1,0,0,0,247620,133593,124920,91453,78657,16885,29021,28989,11/01/2023 05:43:00 AM,11/01/2023 07:28:13 AM,11/01/2023 08:15:10 AM
2023/03/06,DPH Only,15,11,5,0,0,0,58,58,247635,133604,124925,91453,78657,16885,29079,29047,11/01/2023 05:43:00 AM,11/01/2023 07:28:13 AM,11/01/2023 08:15:10 AM
2023/03/07,DPH Only,13,5,8,0,0,0,59,59,247648,133609,124933,91453,78657,16885,29138,29106,11/01/2023 05:43:00 AM,11/01/2023 07:28:13 AM,11/01/2023 08:15:10 AM
2023/03/08,DPH Only,13,8,6,0,0,0,69,69,247661,133617,124939,91453,78657,16885,29207,29175,11/01/2023 05:43:00 AM,11/01/2023 07:28:13 AM,11/01/2023 08:15:10 AM
2023/03/09,DPH Only,11,8,3,2,1,0,63,62,247672,133625,124942,91455,78658,16885,29270,29237,11/01/2023 05:43:00 AM,11/01/2023 07:28:13 AM,11/01/2023 08:15:10 AM
2023/03/10,DPH Only,12,7,7,0,0,0,70,70,247684,133632,124949,91455,78658,16885,29340,29307,11/01/2023 05:43:00 AM,11/01/2023 07:28:13 AM,11/01/2023 08:15:10 AM
2023/03/11,DPH Only,1,1,0,1,0,1,2,2,247685,133633,124949,91456,78658,16886,29342,29309,11/01/2023 05:43:00 AM,11/01/2023 07:28:13 AM,11/01/2023 08:15:10 AM
2023/03/12,DPH Only,0,0,0,0,0,0,0,0,247685,133633,124949,91456,78658,16886,29342,29309,11/01/2023 05:43:00 AM,11/01/2023 07:28:13 AM,11/01/2023 08:15:10 AM
2023/03/13,DPH Only,13,7,6,2,2,1,68,68,247698,133640,124955,91458,78660,16887,29410,29377,11/01/2023 05:43:00 AM,11/01/2023 07:28:13 AM,11/01/2023 08:15:10 AM
2023/03/14,DPH Only,17,8,11,1,1,0,47,47,247715,133648,124966,91459,78661,16887,29457,29424,11/01/2023 05:43:00 AM,11/01/2023 07:28:13 AM,11/01/2023 08:15:10 AM
2023/03/15,DPH Only,13,10,4,2,2,1,47,46,247728,133658,124970,91461,78663,16888,29504,29470,11/01/2023 05:43:00 AM,11/01/2023 07:28:13 AM,11/01/2023 08:15:10 AM
2023/03/16,DPH Only,10,7,4,1,1,0,72,72,247738,133665,124974,91462,78664,16888,29576,29542,11/01/2023 05:43:00 AM,11/01/2023 07:28:13 AM,11/01/2023 08:15:10 AM
2023/03/17,DPH Only,13,7,9,1,1,0,56,56,247751,133672,124983,91463,78665,16888,29632,29598,11/01/2023 05:43:00 AM,11/01/2023 07:28:13 AM,11/01/2023 08:15:10 AM
2023/03/18,DPH Only,0,0,0,0,0,0,2,2,247751,133672,124983,91463,78665,16888,29634,29600,11/01/2023 05:43:00 AM,11/01/2023 07:28:13 AM,11/01/2023 08:15:10 AM
2023/03/19,DPH Only,0,0,0,0,0,0,0,0,247751,133672,124983,91463,78665,16888,29634,29600,11/01/2023 05:43:00 AM,11/01/2023 07:28:13 AM,11/01/2023 08:15:10 AM
2023/03/20,DPH Only,10,6,8,0,0,0,71,71,247761,133678,124991,91463,78665,16888,29705,29671,11/01/2023 05:43:00 AM,11/01/2023 07:28:13 AM,11/01/2023 08:15:10 AM
2023/03/21,DPH Only,11,9,2,2,1,2,47,47,247772,133687,124993,91465,78666,16890,29752,29718,11/01/2023 05:43:00 AM,11/01/2023 07:28:13 AM,11/01/2023 08:15:10 AM
2023/03/22,DPH Only,7,4,4,0,0,0,41,41,247779,133691,124997,91465,78666,16890,29793,29759,11/01/2023 05:43:00 AM,11/01/2023 07:28:13 AM,11/01/2023 08:15:10 AM
2023/03/23,DPH Only,13,8,6,1,1,1,60,60,247792,133699,125003,91466,78667,16891,29853,29819,11/01/2023 05:43:00 AM,11/01/2023 07:28:13 AM,11/01/2023 08:15:10 AM
2023/03/24,DPH Only,9,6,3,1,0,1,42,42,247801,133705,125006,91467,78667,16892,29895,29861,11/01/2023 05:43:00 AM,11/01/2023 07:28:13 AM,11/01/2023 08:15:10 AM
2023/03/25,DPH Only,0,0,0,0,0,0,5,5,247801,133705,125006,91467,78667,16892,29900,29866,11/01/2023 05:43:00 AM,11/01/2023 07:28:13 AM,11/01/2023 08:15:10 AM
2023/03/26,DPH Only,0,0,0,0,0,0,0,0,247801,133705,125006,91467,78667,16892,29900,29866,11/01/2023 05:43:00 AM,11/01/2023 07:28:13 AM,11/01/2023 08:15:10 AM
2023/03/27,DPH Only,11,5,7,0,0,0,65,64,247812,133710,125013,91467,78667,16892,29965,29930,11/01/2023 05:43:00 AM,11/01/2023 07:28:13 AM,11/01/2023 08:15:10 AM
2023/03/28,DPH Only,5,2,3,1,1,0,37,37,247817,133712,125016,91468,78668,16892,30002,29967,11/01/2023 05:43:00 AM,11/01/2023 07:28:13 AM,11/01/2023 08:15:10 AM
2023/03/29,DPH Only,18,8,10,2,1,0,61,60,247835,133720,125026,91470,78669,16892,30063,30027,11/01/2023 05:43:00 AM,11/01/2023 07:28:13 AM,11/01/2023 08:15:10 AM
2023/03/30,DPH Only,12,5,8,0,0,0,74,73,247847,133725,125034,91470,78669,16892,30137,30100,11/01/2023 05:43:00 AM,11/01/2023 07:28:13 AM,11/01/2023 08:15:10 AM
2023/03/31,DPH Only,10,6,9,0,0,0,43,42,247857,133731,125043,91470,78669,16892,30180,30142,11/01/2023 05:43:00 AM,11/01/2023 07:28:13 AM,11/01/2023 08:15:10 AM
2023/04/01,DPH Only,1,1,0,0,0,0,0,0,247858,133732,125043,91470,78669,16892,30180,30142,11/01/2023 05:43:00 AM,11/01/2023 07:28:13 AM,11/01/2023 08:15:10 AM
2023/04/02,DPH Only,0,0,0,0,0,0,0,0,247858,133732,125043,91470,78669,16892,30180,30142,11/01/2023 05:43:00 AM,11/01/2023 07:28:13 AM,11/01/2023 08:15:10 AM
2023/04/03,DPH Only,10,6,6,1,1,1,47,47,247868,133738,125049,91471,78670,16893,30227,30189,11/01/2023 05:43:00 AM,11/01/2023 07:28:13 AM,11/01/2023 08:15:10 AM
2023/04/04,DPH Only,5,5,3,5,1,4,55,53,247873,133743,125052,91476,78671,16897,30282,30242,11/01/2023 05:43:00 AM,11/01/2023 07:28:13 AM,11/01/2023 08:15:10 AM
2023/04/05,DPH Only,15,13,3,0,0,0,36,36,247888,133756,125055,91476,78671,16897,30318,30278,11/01/2023 05:43:00 AM,11/01/2023 07:28:13 AM,11/01/2023 08:15:10 AM
2023/04/06,DPH Only,7,3,6,2,1,1,28,27,247895,133759,125061,91478,78672,16898,30346,30305,11/01/2023 05:43:00 AM,11/01/2023 07:28:13 AM,11/01/2023 08:15:10 AM
2023/04/07,DPH Only,3,2,2,0,0,0,40,40,247898,133761,125063,91478,78672,16898,30386,30345,11/01/2023 05:43:00 AM,11/01/2023 07:28:13 AM,11/01/2023 08:15:10 AM
2023/04/08,DPH Only,0,0,0,0,0,0,0,0,247898,133761,125063,91478,78672,16898,30386,30345,11/01/2023 05:43:00 AM,11/01/2023 07:28:13 AM,11/01/2023 08:15:10 AM
2023/04/09,DPH Only,0,0,0,0,0,0,0,0,247898,133761,125063,91478,78672,16898,30386,30345,11/01/2023 05:43:00 AM,11/01/2023 07:28:13 AM,11/01/2023 08:15:10 AM
2023/04/10,DPH Only,12,6,7,4,3,2,54,53,247910,133767,125070,91482,78675,16900,30440,30398,11/01/2023 05:43:00 AM,11/01/2023 07:28:13 AM,11/01/2023 08:15:10 AM
2023/04/11,DPH Only,5,3,2,5,2,1,55,55,247915,133770,125072,91487,78677,16901,30495,30453,11/01/2023 05:43:00 AM,11/01/2023 07:28:13 AM,11/01/2023 08:15:10 AM
2023/04/12,DPH Only,5,3,3,0,0,0,43,42,247920,133773,125075,91487,78677,16901,30538,30495,11/01/2023 05:43:00 AM,11/01/2023 07:28:13 AM,11/01/2023 08:15:10 AM
2023/04/13,DPH Only,20,10,14,1,1,0,49,49,247940,133783,125089,91488,78678,16901,30587,30544,11/01/2023 05:43:00 AM,11/01/2023 07:28:13 AM,11/01/2023 08:15:10 AM
2023/04/14,DPH Only,19,11,9,0,0,0,51,51,247959,133794,125098,91488,78678,16901,30638,30595,11/01/2023 05:43:00 AM,11/01/2023 07:28:13 AM,11/01/2023 08:15:10 AM
2023/04/15,DPH Only,0,0,0,0,0,0,0,0,247959,133794,125098,91488,78678,16901,30638,30595,11/01/2023 05:43:00 AM,11/01/2023 07:28:13 AM,11/01/2023 08:15:10 AM
2023/04/16,DPH Only,0,0,0,0,0,0,0,0,247959,133794,125098,91488,78678,16901,30638,30595,11/01/2023 05:43:00 AM,11/01/2023 07:28:13 AM,11/01/2023 08:15:10 AM
2023/04/17,DPH Only,12,8,6,0,0,0,50,50,247971,133802,125104,91488,78678,16901,30688,30645,11/01/2023 05:43:00 AM,11/01/2023 07:28:13 AM,11/01/2023 08:15:10 AM
2023/04/18,DPH Only,4,4,3,4,3,1,75,75,247975,133806,125107,91492,78681,16902,30763,30720,11/01/2023 05:43:00 AM,11/01/2023 07:28:13 AM,11/01/2023 08:15:10 AM
2023/04/19,DPH Only,1,0,2,0,0,0,70,70,247976,133806,125109,91492,78681,16902,30833,30790,11/01/2023 05:43:00 AM,11/01/2023 07:28:13 AM,11/01/2023 08:15:10 AM
2023/04/20,DPH Only,1,1,1,0,0,0,58,58,247977,133807,125110,91492,78681,16902,30891,30848,11/01/2023 05:43:00 AM,11/01/2023 07:28:13 AM,11/01/2023 08:15:10 AM
2023/04/21,DPH Only,2,2,2,1,0,0,45,40,247979,133809,125112,91493,78681,16902,30936,30888,11/01/2023 05:43:00 AM,11/01/2023 07:28:13 AM,11/01/2023 08:15:10 AM
2023/04/22,DPH Only,0,0,0,0,0,0,2,2,247979,133809,125112,91493,78681,16902,30938,30890,11/01/2023 05:43:00 AM,11/01/2023 07:28:13 AM,11/01/2023 08:15:10 AM
2023/04/23,DPH Only,0,0,0,0,0,0,0,0,247979,133809,125112,91493,78681,16902,30938,30890,11/01/2023 05:43:00 AM,11/01/2023 07:28:13 AM,11/01/2023 08:15:10 AM
2023/04/24,DPH Only,1,1,1,1,0,0,69,58,247980,133810,125113,91494,78681,16902,31007,30948,11/01/2023 05:43:00 AM,11/01/2023 07:28:13 AM,11/01/2023 08:15:10 AM
2023/04/25,DPH Only,0,0,3,0,0,0,59,56,247980,133810,125116,91494,78681,16902,31066,31004,11/01/2023 05:43:00 AM,11/01/2023 07:28:13 AM,11/01/2023 08:15:10 AM
2023/04/26,DPH Only,0,0,2,0,0,0,50,39,247980,133810,125118,91494,78681,16902,31116,31043,11/01/2023 05:43:00 AM,11/01/2023 07:28:13 AM,11/01/2023 08:15:10 AM
2023/04/27,DPH Only,0,0,3,0,0,0,47,44,247980,133810,125121,91494,78681,16902,31163,31087,11/01/2023 05:43:00 AM,11/01/2023 07:28:13 AM,11/01/2023 08:15:10 AM
2023/04/28,DPH Only,0,0,0,0,0,0,29,22,247980,133810,125121,91494,78681,16902,31192,31109,11/01/2023 05:43:00 AM,11/01/2023 07:28:13 AM,11/01/2023 08:15:10 AM
2023/04/29,DPH Only,0,0,0,1,1,1,0,0,247980,133810,125121,91495,78682,16903,31192,31109,11/01/2023 05:43:00 AM,11/01/2023 07:28:13 AM,11/01/2023 08:15:10 AM
2023/04/30,DPH Only,0,0,0,0,0,0,0,0,247980,133810,125121,91495,78682,16903,31192,31109,11/01/2023 05:43:00 AM,11/01/2023 07:28:13 AM,11/01/2023 08:15:10 AM
2023/05/01,DPH Only,0,0,1,1,0,1,47,39,247980,133810,125122,91496,78682,16904,31239,31148,11/01/2023 05:43:00 AM,11/01/2023 07:28:13 AM,11/01/2023 08:15:10 AM
2023/05/02,DPH Only,0,0,1,1,1,1,48,42,247980,133810,125123,91497,78683,16905,31287,31190,11/01/2023 05:43:00 AM,11/01/2023 07:28:13 AM,11/01/2023 08:15:10 AM
2023/05/03,DPH Only,0,0,1,0,0,0,56,42,247980,133810,125124,91497,78683,16905,31343,31232,11/01/2023 05:43:00 AM,11/01/2023 07:28:13 AM,11/01/2023 08:15:10 AM
2023/05/04,DPH Only,2,2,5,0,0,0,67,50,247982,133812,125129,91497,78683,16905,31410,31282,11/01/2023 05:43:00 AM,11/01/2023 07:28:13 AM,11/01/2023 08:15:10 AM
2023/05/05,DPH Only,0,0,3,1,0,0,66,33,247982,133812,125132,91498,78683,16905,31476,31315,11/01/2023 05:43:00 AM,11/01/2023 07:28:13 AM,11/01/2023 08:15:10 AM
2023/05/06,DPH Only,0,0,0,0,0,0,0,0,247982,133812,125132,91498,78683,16905,31476,31315,11/01/2023 05:43:00 AM,11/01/2023 07:28:13 AM,11/01/2023 08:15:10 AM
2023/05/07,DPH Only,0,0,0,0,0,0,0,0,247982,133812,125132,91498,78683,16905,31476,31315,11/01/2023 05:43:00 AM,11/01/2023 07:28:13 AM,11/01/2023 08:15:10 AM
2023/05/08,DPH Only,1,0,3,1,0,1,80,46,247983,133812,125135,91499,78683,16906,31556,31361,11/01/2023 05:43:00 AM,11/01/2023 07:28:13 AM,11/01/2023 08:15:10 AM
2023/05/09,DPH Only,0,0,2,0,0,0,92,52,247983,133812,125137,91499,78683,16906,31648,31413,11/01/2023 05:43:00 AM,11/01/2023 07:28:13 AM,11/01/2023 08:15:10 AM
2023/05/10,DPH Only,0,0,6,1,0,1,156,109,247983,133812,125143,91500,78683,16907,31804,31522,11/01/2023 05:43:00 AM,11/01/2023 07:28:13 AM,11/01/2023 08:15:10 AM
2023/05/11,DPH Only,0,0,0,0,0,0,82,47,247983,133812,125143,91500,78683,16907,31886,31569,11/01/2023 05:43:00 AM,11/01/2023 07:28:13 AM,11/01/2023 08:15:10 AM
2023/05/12,DPH Only,1,0,2,0,0,0,55,38,247984,133812,125145,91500,78683,16907,31941,31607,11/01/2023 05:43:00 AM,11/01/2023 07:28:13 AM,11/01/2023 08:15:10 AM
2023/05/13,DPH Only,0,0,0,0,0,0,5,5,247984,133812,125145,91500,78683,16907,31946,31612,11/01/2023 05:43:00 AM,11/01/2023 07:28:13 AM,11/01/2023 08:15:10 AM
2023/05/14,DPH Only,0,0,0,0,0,0,0,0,247984,133812,125145,91500,78683,16907,31946,31612,11/01/2023 05:43:00 AM,11/01/2023 07:28:13 AM,11/01/2023 08:15:10 AM
2023/05/15,DPH Only,1,1,3,0,0,0,66,49,247985,133813,125148,91500,78683,16907,32012,31661,11/01/2023 05:43:00 AM,11/01/2023 07:28:13 AM,11/01/2023 08:15:10 AM
2023/05/16,DPH Only,0,0,3,0,0,0,109,71,247985,133813,125151,91500,78683,16907,32121,31732,11/01/2023 05:43:00 AM,11/01/2023 07:28:13 AM,11/01/2023 08:15:10 AM
2023/05/17,DPH Only,0,0,4,1,1,0,71,40,247985,133813,125155,91501,78684,16907,32192,31772,11/01/2023 05:43:00 AM,11/01/2023 07:28:13 AM,11/01/2023 08:15:10 AM
2023/05/18,DPH Only,0,0,3,0,0,0,102,46,247985,133813,125158,91501,78684,16907,32294,31818,11/01/2023 05:43:00 AM,11/01/2023 07:28:13 AM,11/01/2023 08:15:10 AM
2023/05/19,DPH Only,0,0,1,0,0,0,57,41,247985,133813,125159,91501,78684,16907,32351,31859,11/01/2023 05:43:00 AM,11/01/2023 07:28:13 AM,11/01/2023 08:15:10 AM
2023/05/20,DPH Only,0,0,0,0,0,0,0,0,247985,133813,125159,91501,78684,16907,32351,31859,11/01/2023 05:43:00 AM,11/01/2023 07:28:13 AM,11/01/2023 08:15:10 AM
2023/05/21,DPH Only,0,0,0,0,0,0,0,0,247985,133813,125159,91501,78684,16907,32351,31859,11/01/2023 05:43:00 AM,11/01/2023 07:28:13 AM,11/01/2023 08:15:10 AM
2023/05/22,DPH Only,1,1,6,1,0,0,94,57,247986,133814,125165,91502,78684,16907,32445,31916,11/01/2023 05:43:00 AM,11/01/2023 07:28:13 AM,11/01/2023 08:15:10 AM
2023/05/23,DPH Only,3,1,3,2,1,1,71,52,247989,133815,125168,91504,78685,16908,32516,31968,11/01/2023 05:43:00 AM,11/01/2023 07:28:13 AM,11/01/2023 08:15:10 AM
2023/05/24,DPH Only,0,0,6,0,0,0,82,64,247989,133815,125174,91504,78685,16908,32598,32032,11/01/2023 05:43:00 AM,11/01/2023 07:28:13 AM,11/01/2023 08:15:10 AM
2023/05/25,DPH Only,1,0,7,0,0,0,87,65,247990,133815,125181,91504,78685,16908,32685,32097,11/01/2023 05:43:00 AM,11/01/2023 07:28:13 AM,11/01/2023 08:15:10 AM
2023/05/26,DPH Only,2,0,5,0,0,0,46,30,247992,133815,125186,91504,78685,16908,32731,32127,11/01/2023 05:43:00 AM,11/01/2023 07:28:13 AM,11/01/2023 08:15:10 AM
2023/05/27,DPH Only,0,0,0,0,0,0,0,0,247992,133815,125186,91504,78685,16908,32731,32127,11/01/2023 05:43:00 AM,11/01/2023 07:28:13 AM,11/01/2023 08:15:10 AM
2023/05/28,DPH Only,0,0,0,0,0,0,0,0,247992,133815,125186,91504,78685,16908,32731,32127,11/01/2023 05:43:00 AM,11/01/2023 07:28:13 AM,11/01/2023 08:15:10 AM
2023/05/29,DPH Only,0,0,0,0,0,0,1,1,247992,133815,125186,91504,78685,16908,32732,32128,11/01/2023 05:43:00 AM,11/01/2023 07:28:13 AM,11/01/2023 08:15:10 AM
2023/05/30,DPH Only,1,1,3,1,1,0,48,36,247993,133816,125189,91505,78686,16908,32780,32164,11/01/2023 05:43:00 AM,11/01/2023 07:28:13 AM,11/01/2023 08:15:10 AM
2023/05/31,DPH Only,1,1,0,1,1,1,64,40,247994,133817,125189,91506,78687,16909,32844,32204,11/01/2023 05:43:00 AM,11/01/2023 07:28:13 AM,11/01/2023 08:15:10 AM
2023/06/01,DPH Only,0,0,3,0,0,0,66,42,247994,133817,125192,91506,78687,16909,32910,32246,11/01/2023 05:43:00 AM,11/01/2023 07:28:13 AM,11/01/2023 08:15:10 AM
2023/06/02,DPH Only,1,1,0,0,0,0,44,26,247995,133818,125192,91506,78687,16909,32954,32272,11/01/2023 05:43:00 AM,11/01/2023 07:28:13 AM,11/01/2023 08:15:10 AM
2023/06/03,DPH Only,0,0,0,0,0,0,0,0,247995,133818,125192,91506,78687,16909,32954,32272,11/01/2023 05:43:00 AM,11/01/2023 07:28:13 AM,11/01/2023 08:15:10 AM
2023/06/04,DPH Only,1,0,1,0,0,0,0,0,247996,133818,125193,91506,78687,16909,32954,32272,11/01/2023 05:43:00 AM,11/01/2023 07:28:13 AM,11/01/2023 08:15:10 AM
2023/06/05,DPH Only,0,0,0,0,0,0,42,26,247996,133818,125193,91506,78687,16909,32996,32298,11/01/2023 05:43:00 AM,11/01/2023 07:28:13 AM,11/01/2023 08:15:10 AM
2023/06/06,DPH Only,0,0,2,1,0,0,52,43,247996,133818,125195,91507,78687,16909,33048,32341,11/01/2023 05:43:00 AM,11/01/2023 07:28:13 AM,11/01/2023 08:15:10 AM
2023/06/07,DPH Only,0,0,2,0,0,0,52,30,247996,133818,125197,91507,78687,16909,33100,32371,11/01/2023 05:43:00 AM,11/01/2023 07:28:13 AM,11/01/2023 08:15:10 AM
2023/06/08,DPH Only,0,0,4,1,1,0,78,57,247996,133818,125201,91508,78688,16909,33178,32428,11/01/2023 05:43:00 AM,11/01/2023 07:28:13 AM,11/01/2023 08:15:10 AM
2023/06/09,DPH Only,0,0,0,0,0,0,53,47,247996,133818,125201,91508,78688,16909,33231,32475,11/01/2023 05:43:00 AM,11/01/2023 07:28:13 AM,11/01/2023 08:15:10 AM
2023/06/10,DPH Only,0,0,0,0,0,0,3,3,247996,133818,125201,91508,78688,16909,33234,32478,11/01/2023 05:43:00 AM,11/01/2023 07:28:13 AM,11/01/2023 08:15:10 AM
2023/06/11,DPH Only,0,0,0,0,0,0,1,1,247996,133818,125201,91508,78688,16909,33235,32479,11/01/2023 05:43:00 AM,11/01/2023 07:28:13 AM,11/01/2023 08:15:10 AM
2023/06/12,DPH Only,0,0,2,0,0,0,60,45,247996,133818,125203,91508,78688,16909,33295,32524,11/01/2023 05:43:00 AM,11/01/2023 07:28:13 AM,11/01/2023 08:15:10 AM
2023/06/13,DPH Only,1,0,4,0,0,0,42,26,247997,133818,125207,91508,78688,16909,33337,32550,11/01/2023 05:43:00 AM,11/01/2023 07:28:13 AM,11/01/2023 08:15:10 AM
2023/06/14,DPH Only,0,0,2,0,0,0,46,31,247997,133818,125209,91508,78688,16909,33383,32581,11/01/2023 05:43:00 AM,11/01/2023 07:28:13 AM,11/01/2023 08:15:10 AM
2023/06/15,DPH Only,0,0,1,0,0,0,64,56,247997,133818,125210,91508,78688,16909,33447,32637,11/01/2023 05:43:00 AM,11/01/2023 07:28:13 AM,11/01/2023 08:15:10 AM
2023/06/16,DPH Only,0,0,5,0,0,0,47,33,247997,133818,125215,91508,78688,16909,33494,32670,11/01/2023 05:43:00 AM,11/01/2023 07:28:13 AM,11/01/2023 08:15:10 AM
2023/06/17,DPH Only,0,0,0,0,0,0,7,6,247997,133818,125215,91508,78688,16909,33501,32676,11/01/2023 05:43:00 AM,11/01/2023 07:28:13 AM,11/01/2023 08:15:10 AM
2023/06/18,DPH Only,0,0,0,0,0,0,0,0,247997,133818,125215,91508,78688,16909,33501,32676,11/01/2023 05:43:00 AM,11/01/2023 07:28:13 AM,11/01/2023 08:15:10 AM
2023/06/19,DPH Only,0,0,0,0,0,0,1,1,247997,133818,125215,91508,78688,16909,33502,32677,11/01/2023 05:43:00 AM,11/01/2023 07:28:13 AM,11/01/2023 08:15:10 AM
2023/06/20,DPH Only,1,1,1,2,1,2,56,43,247998,133819,125216,91510,78689,16911,33558,32720,11/01/2023 05:43:00 AM,11/01/2023 07:28:13 AM,11/01/2023 08:15:10 AM
2023/06/21,DPH Only,0,0,0,2,1,1,34,19,247998,133819,125216,91512,78690,16912,33592,32739,11/01/2023 05:43:00 AM,11/01/2023 07:28:13 AM,11/01/2023 08:15:10 AM
2023/06/22,DPH Only,0,0,1,0,0,0,84,47,247998,133819,125217,91512,78690,16912,33676,32786,11/01/2023 05:43:00 AM,11/01/2023 07:28:13 AM,11/01/2023 08:15:10 AM
2023/06/23,DPH Only,0,0,3,0,0,0,51,30,247998,133819,125220,91512,78690,16912,33727,32816,11/01/2023 05:43:00 AM,11/01/2023 07:28:13 AM,11/01/2023 08:15:10 AM
2023/06/24,DPH Only,0,0,0,0,0,0,0,0,247998,133819,125220,91512,78690,16912,33727,32816,11/01/2023 05:43:00 AM,11/01/2023 07:28:13 AM,11/01/2023 08:15:10 AM
2023/06/25,DPH Only,0,0,0,0,0,0,0,0,247998,133819,125220,91512,78690,16912,33727,32816,11/01/2023 05:43:00 AM,11/01/2023 07:28:13 AM,11/01/2023 08:15:10 AM
2023/06/26,DPH Only,0,0,1,0,0,0,44,27,247998,133819,125221,91512,78690,16912,33771,32843,11/01/2023 05:43:00 AM,11/01/2023 07:28:13 AM,11/01/2023 08:15:10 AM
2023/06/27,DPH Only,0,0,1,0,0,0,56,37,247998,133819,125222,91512,78690,16912,33827,32880,11/01/2023 05:43:00 AM,11/01/2023 07:28:13 AM,11/01/2023 08:15:10 AM
2023/06/28,DPH Only,0,0,2,0,0,0,70,52,247998,133819,125224,91512,78690,16912,33897,32932,11/01/2023 05:43:00 AM,11/01/2023 07:28:13 AM,11/01/2023 08:15:10 AM
2023/06/29,DPH Only,0,0,5,0,0,0,62,49,247998,133819,125229,91512,78690,16912,33959,32981,11/01/2023 05:43:00 AM,11/01/2023 07:28:13 AM,11/01/2023 08:15:10 AM
2023/06/30,DPH Only,0,0,0,0,0,0,41,27,247998,133819,125229,91512,78690,16912,34000,33008,11/01/2023 05:43:00 AM,11/01/2023 07:28:13 AM,11/01/2023 08:15:10 AM
2023/07/01,DPH Only,0,0,0,0,0,0,1,1,247998,133819,125229,91512,78690,16912,34001,33009,11/01/2023 05:43:00 AM,11/01/2023 07:28:13 AM,11/01/2023 08:15:10 AM
2023/07/02,DPH Only,0,0,0,0,0,0,0,0,247998,133819,125229,91512,78690,16912,34001,33009,11/01/2023 05:43:00 AM,11/01/2023 07:28:13 AM,11/01/2023 08:15:10 AM
2023/07/03,DPH Only,0,0,4,0,0,0,45,25,247998,133819,125233,91512,78690,16912,34046,33034,11/01/2023 05:43:00 AM,11/01/2023 07:28:13 AM,11/01/2023 08:15:10 AM
2023/07/04,DPH Only,0,0,0,0,0,0,0,0,247998,133819,125233,91512,78690,16912,34046,33034,11/01/2023 05:43:00 AM,11/01/2023 07:28:13 AM,11/01/2023 08:15:10 AM
2023/07/05,DPH Only,0,0,4,0,0,0,57,43,247998,133819,125237,91512,78690,16912,34103,33077,11/01/2023 05:43:00 AM,11/01/2023 07:28:13 AM,11/01/2023 08:15:10 AM
2023/07/06,DPH Only,0,0,3,0,0,0,67,53,247998,133819,125240,91512,78690,16912,34170,33130,11/01/2023 05:43:00 AM,11/01/2023 07:28:13 AM,11/01/2023 08:15:10 AM
2023/07/07,DPH Only,0,0,3,0,0,0,63,40,247998,133819,125243,91512,78690,16912,34233,33170,11/01/2023 05:43:00 AM,11/01/2023 07:28:13 AM,11/01/2023 08:15:10 AM
2023/07/08,DPH Only,0,0,0,0,0,0,9,7,247998,133819,125243,91512,78690,16912,34242,33177,11/01/2023 05:43:00 AM,11/01/2023 07:28:13 AM,11/01/2023 08:15:10 AM
2023/07/09,DPH Only,0,0,0,0,0,0,0,0,247998,133819,125243,91512,78690,16912,34242,33177,11/01/2023 05:43:00 AM,11/01/2023 07:28:13 AM,11/01/2023 08:15:10 AM
2023/07/10,DPH Only,0,0,2,0,0,0,51,30,247998,133819,125245,91512,78690,16912,34293,33207,11/01/2023 05:43:00 AM,11/01/2023 07:28:13 AM,11/01/2023 08:15:10 AM
2023/07/11,DPH Only,0,0,1,0,0,0,54,37,247998,133819,125246,91512,78690,16912,34347,33244,11/01/2023 05:43:00 AM,11/01/2023 07:28:13 AM,11/01/2023 08:15:10 AM
2023/07/12,DPH Only,0,0,2,0,0,0,62,49,247998,133819,125248,91512,78690,16912,34409,33293,11/01/2023 05:43:00 AM,11/01/2023 07:28:13 AM,11/01/2023 08:15:10 AM
2023/07/13,DPH Only,0,0,3,0,0,0,85,62,247998,133819,125251,91512,78690,16912,34494,33355,11/01/2023 05:43:00 AM,11/01/2023 07:28:13 AM,11/01/2023 08:15:10 AM
2023/07/14,DPH Only,0,0,1,0,0,0,45,22,247998,133819,125252,91512,78690,16912,34539,33377,11/01/2023 05:43:00 AM,11/01/2023 07:28:13 AM,11/01/2023 08:15:10 AM
2023/07/15,DPH Only,0,0,0,0,0,0,0,0,247998,133819,125252,91512,78690,16912,34539,33377,11/01/2023 05:43:00 AM,11/01/2023 07:28:13 AM,11/01/2023 08:15:10 AM
2023/07/16,DPH Only,0,0,0,0,0,0,0,0,247998,133819,125252,91512,78690,16912,34539,33377,11/01/2023 05:43:00 AM,11/01/2023 07:28:13 AM,11/01/2023 08:15:10 AM
2023/07/17,DPH Only,0,0,0,0,0,0,56,33,247998,133819,125252,91512,78690,16912,34595,33410,11/01/2023 05:43:00 AM,11/01/2023 07:28:13 AM,11/01/2023 08:15:10 AM
2023/07/18,DPH Only,0,0,2,0,0,0,62,29,247998,133819,125254,91512,78690,16912,34657,33439,11/01/2023 05:43:00 AM,11/01/2023 07:28:13 AM,11/01/2023 08:15:10 AM
2023/07/19,DPH Only,0,0,1,0,0,0,117,36,247998,133819,125255,91512,78690,16912,34774,33475,11/01/2023 05:43:00 AM,11/01/2023 07:28:13 AM,11/01/2023 08:15:10 AM
2023/07/20,DPH Only,0,0,2,0,0,0,41,28,247998,133819,125257,91512,78690,16912,34815,33503,11/01/2023 05:43:00 AM,11/01/2023 07:28:13 AM,11/01/2023 08:15:10 AM
2023/07/21,DPH Only,0,0,0,0,0,0,39,25,247998,133819,125257,91512,78690,16912,34854,33528,11/01/2023 05:43:00 AM,11/01/2023 07:28:13 AM,11/01/2023 08:15:10 AM
2023/07/22,DPH Only,0,0,0,0,0,0,0,0,247998,133819,125257,91512,78690,16912,34854,33528,11/01/2023 05:43:00 AM,11/01/2023 07:28:13 AM,11/01/2023 08:15:10 AM
2023/07/23,DPH Only,0,0,0,0,0,0,0,0,247998,133819,125257,91512,78690,16912,34854,33528,11/01/2023 05:43:00 AM,11/01/2023 07:28:13 AM,11/01/2023 08:15:10 AM
2023/07/24,DPH Only,0,0,3,0,0,0,55,38,247998,133819,125260,91512,78690,16912,34909,33566,11/01/2023 05:43:00 AM,11/01/2023 07:28:13 AM,11/01/2023 08:15:10 AM
2023/07/25,DPH Only,0,0,0,0,0,0,64,40,247998,133819,125260,91512,78690,16912,34973,33606,11/01/2023 05:43:00 AM,11/01/2023 07:28:13 AM,11/01/2023 08:15:10 AM
2023/07/26,DPH Only,1,1,4,0,0,0,62,47,247999,133820,125264,91512,78690,16912,35035,33653,11/01/2023 05:43:00 AM,11/01/2023 07:28:13 AM,11/01/2023 08:15:10 AM
2023/07/27,DPH Only,0,0,1,0,0,0,38,31,247999,133820,125265,91512,78690,16912,35073,33684,11/01/2023 05:43:00 AM,11/01/2023 07:28:13 AM,11/01/2023 08:15:10 AM
2023/07/28,DPH Only,0,0,2,0,0,0,51,34,247999,133820,125267,91512,78690,16912,35124,33718,11/01/2023 05:43:00 AM,11/01/2023 07:28:13 AM,11/01/2023 08:15:10 AM
2023/07/29,DPH Only,0,0,0,0,0,0,0,0,247999,133820,125267,91512,78690,16912,35124,33718,11/01/2023 05:43:00 AM,11/01/2023 07:28:13 AM,11/01/2023 08:15:10 AM
2023/07/30,DPH Only,0,0,0,0,0,0,0,0,247999,133820,125267,91512,78690,16912,35124,33718,11/01/2023 05:43:00 AM,11/01/2023 07:28:13 AM,11/01/2023 08:15:10 AM
2023/07/31,DPH Only,0,0,1,0,0,0,47,26,247999,133820,125268,91512,78690,16912,35171,33744,11/01/2023 05:43:00 AM,11/01/2023 07:28:13 AM,11/01/2023 08:15:10 AM
2023/08/01,DPH Only,0,0,4,0,0,0,53,42,247999,133820,125272,91512,78690,16912,35224,33786,11/01/2023 05:43:00 AM,11/01/2023 07:28:13 AM,11/01/2023 08:15:10 AM
2023/08/02,DPH Only,0,0,2,0,0,0,66,47,247999,133820,125274,91512,78690,16912,35290,33833,11/01/2023 05:43:00 AM,11/01/2023 07:28:13 AM,11/01/2023 08:15:10 AM
2023/08/03,DPH Only,0,0,3,0,0,0,68,43,247999,133820,125277,91512,78690,16912,35358,33876,11/01/2023 05:43:00 AM,11/01/2023 07:28:13 AM,11/01/2023 08:15:10 AM
2023/08/04,DPH Only,0,0,0,0,0,0,45,18,247999,133820,125277,91512,78690,16912,35403,33894,11/01/2023 05:43:00 AM,11/01/2023 07:28:13 AM,11/01/2023 08:15:10 AM
2023/08/05,DPH Only,0,0,0,0,0,0,0,0,247999,133820,125277,91512,78690,16912,35403,33894,11/01/2023 05:43:00 AM,11/01/2023 07:28:13 AM,11/01/2023 08:15:10 AM
2023/08/06,DPH Only,0,0,0,0,0,0,0,0,247999,133820,125277,91512,78690,16912,35403,33894,11/01/2023 05:43:00 AM,11/01/2023 07:28:13 AM,11/01/2023 08:15:10 AM
2023/08/07,DPH Only,0,0,0,0,0,0,34,20,247999,133820,125277,91512,78690,16912,35437,33914,11/01/2023 05:43:00 AM,11/01/2023 07:28:13 AM,11/01/2023 08:15:10 AM
2023/08/08,DPH Only,0,0,1,0,0,0,37,26,247999,133820,125278,91512,78690,16912,35474,33940,11/01/2023 05:43:00 AM,11/01/2023 07:28:13 AM,11/01/2023 08:15:10 AM
2023/08/09,DPH Only,0,0,5,0,0,0,45,36,247999,133820,125283,91512,78690,16912,35519,33976,11/01/2023 05:43:00 AM,11/01/2023 07:28:13 AM,11/01/2023 08:15:10 AM
2023/08/10,DPH Only,0,0,4,0,0,0,58,44,247999,133820,125287,91512,78690,16912,35577,34020,11/01/2023 05:43:00 AM,11/01/2023 07:28:13 AM,11/01/2023 08:15:10 AM
2023/08/11,DPH Only,0,0,3,0,0,0,31,25,247999,133820,125290,91512,78690,16912,35608,34045,11/01/2023 05:43:00 AM,11/01/2023 07:28:13 AM,11/01/2023 08:15:10 AM
2023/08/12,DPH Only,0,0,0,0,0,0,1,1,247999,133820,125290,91512,78690,16912,35609,34046,11/01/2023 05:43:00 AM,11/01/2023 07:28:13 AM,11/01/2023 08:15:10 AM
2023/08/13,DPH Only,0,0,0,0,0,0,0,0,247999,133820,125290,91512,78690,16912,35609,34046,11/01/2023 05:43:00 AM,11/01/2023 07:28:13 AM,11/01/2023 08:15:10 AM
2023/08/14,DPH Only,0,0,2,1,0,0,51,34,247999,133820,125292,91513,78690,16912,35660,34080,11/01/2023 05:43:00 AM,11/01/2023 07:28:13 AM,11/01/2023 08:15:10 AM
2023/08/15,DPH Only,0,0,0,0,0,0,48,38,247999,133820,125292,91513,78690,16912,35708,34118,11/01/2023 05:43:00 AM,11/01/2023 07:28:13 AM,11/01/2023 08:15:10 AM
2023/08/16,DPH Only,0,0,3,0,0,0,39,26,247999,133820,125295,91513,78690,16912,35747,34144,11/01/2023 05:43:00 AM,11/01/2023 07:28:13 AM,11/01/2023 08:15:10 AM
2023/08/17,DPH Only,0,0,3,0,0,0,108,50,247999,133820,125298,91513,78690,16912,35855,34194,11/01/2023 05:43:00 AM,11/01/2023 07:28:13 AM,11/01/2023 08:15:10 AM
2023/08/18,DPH Only,0,0,1,0,0,0,41,30,247999,133820,125299,91513,78690,16912,35896,34224,11/01/2023 05:43:00 AM,11/01/2023 07:28:13 AM,11/01/2023 08:15:10 AM
2023/08/19,DPH Only,0,0,0,0,0,0,1,0,247999,133820,125299,91513,78690,16912,35897,34224,11/01/2023 05:43:00 AM,11/01/2023 07:28:13 AM,11/01/2023 08:15:10 AM
2023/08/20,DPH Only,0,0,0,0,0,0,0,0,247999,133820,125299,91513,78690,16912,35897,34224,11/01/2023 05:43:00 AM,11/01/2023 07:28:13 AM,11/01/2023 08:15:10 AM
2023/08/21,DPH Only,0,0,3,0,0,0,40,26,247999,133820,125302,91513,78690,16912,35937,34250,11/01/2023 05:43:00 AM,11/01/2023 07:28:13 AM,11/01/2023 08:15:10 AM
2023/08/22,DPH Only,0,0,3,0,0,0,44,29,247999,133820,125305,91513,78690,16912,35981,34279,11/01/2023 05:43:00 AM,11/01/2023 07:28:13 AM,11/01/2023 08:15:10 AM
2023/08/23,DPH Only,0,0,2,0,0,0,24,14,247999,133820,125307,91513,78690,16912,36005,34293,11/01/2023 05:43:00 AM,11/01/2023 07:28:13 AM,11/01/2023 08:15:10 AM
2023/08/24,DPH Only,0,0,4,0,0,0,65,49,247999,133820,125311,91513,78690,16912,36070,34342,11/01/2023 05:43:00 AM,11/01/2023 07:28:13 AM,11/01/2023 08:15:10 AM
2023/08/25,DPH Only,0,0,2,0,0,0,40,26,247999,133820,125313,91513,78690,16912,36110,34368,11/01/2023 05:43:00 AM,11/01/2023 07:28:13 AM,11/01/2023 08:15:10 AM
2023/08/26,DPH Only,0,0,0,0,0,0,0,0,247999,133820,125313,91513,78690,16912,36110,34368,11/01/2023 05:43:00 AM,11/01/2023 07:28:13 AM,11/01/2023 08:15:10 AM
2023/08/27,DPH Only,0,0,0,0,0,0,0,0,247999,133820,125313,91513,78690,16912,36110,34368,11/01/2023 05:43:00 AM,11/01/2023 07:28:13 AM,11/01/2023 08:15:10 AM
2023/08/28,DPH Only,0,0,0,0,0,0,39,26,247999,133820,125313,91513,78690,16912,36149,34394,11/01/2023 05:43:00 AM,11/01/2023 07:28:13 AM,11/01/2023 08:15:10 AM
2023/08/29,DPH Only,0,0,1,0,0,0,40,28,247999,133820,125314,91513,78690,16912,36189,34422,11/01/2023 05:43:00 AM,11/01/2023 07:28:13 AM,11/01/2023 08:15:10 AM
2023/08/30,DPH Only,0,0,1,0,0,0,44,29,247999,133820,125315,91513,78690,16912,36233,34451,11/01/2023 05:43:00 AM,11/01/2023 07:28:13 AM,11/01/2023 08:15:10 AM
2023/08/31,DPH Only,0,0,0,0,0,0,36,29,247999,133820,125315,91513,78690,16912,36269,34480,11/01/2023 05:43:00 AM,11/01/2023 07:28:13 AM,11/01/2023 08:15:10 AM
2023/09/01,DPH Only,0,0,0,0,0,0,34,25,247999,133820,125315,91513,78690,16912,36303,34505,11/01/2023 05:43:00 AM,11/01/2023 07:28:13 AM,11/01/2023 08:15:10 AM
2023/09/02,DPH Only,0,0,0,0,0,0,1,1,247999,133820,125315,91513,78690,16912,36304,34506,11/01/2023 05:43:00 AM,11/01/2023 07:28:13 AM,11/01/2023 08:15:10 AM
2023/09/03,DPH Only,0,0,0,0,0,0,0,0,247999,133820,125315,91513,78690,16912,36304,34506,11/01/2023 05:43:00 AM,11/01/2023 07:28:13 AM,11/01/2023 08:15:10 AM
2023/09/04,DPH Only,0,0,0,0,0,0,0,0,247999,133820,125315,91513,78690,16912,36304,34506,11/01/2023 05:43:00 AM,11/01/2023 07:28:13 AM,11/01/2023 08:15:10 AM
2023/09/05,DPH Only,0,0,1,0,0,0,38,26,247999,133820,125316,91513,78690,16912,36342,34532,11/01/2023 05:43:00 AM,11/01/2023 07:28:13 AM,11/01/2023 08:15:10 AM
2023/09/06,DPH Only,0,0,1,1,1,0,29,21,247999,133820,125317,91514,78691,16912,36371,34553,11/01/2023 05:43:00 AM,11/01/2023 07:28:13 AM,11/01/2023 08:15:10 AM
2023/09/07,DPH Only,0,0,2,0,0,0,34,25,247999,133820,125319,91514,78691,16912,36405,34578,11/01/2023 05:43:00 AM,11/01/2023 07:28:13 AM,11/01/2023 08:15:10 AM
2023/09/08,DPH Only,0,0,2,0,0,0,18,11,247999,133820,125321,91514,78691,16912,36423,34589,11/01/2023 05:43:00 AM,11/01/2023 07:28:13 AM,11/01/2023 08:15:10 AM
2023/09/09,DPH Only,0,0,0,0,0,0,0,0,247999,133820,125321,91514,78691,16912,36423,34589,11/01/2023 05:43:00 AM,11/01/2023 07:28:13 AM,11/01/2023 08:15:10 AM
2023/09/10,DPH Only,0,0,0,0,0,0,0,0,247999,133820,125321,91514,78691,16912,36423,34589,11/01/2023 05:43:00 AM,11/01/2023 07:28:13 AM,11/01/2023 08:15:10 AM
2023/09/11,DPH Only,0,0,1,0,0,0,20,12,247999,133820,125322,91514,78691,16912,36443,34601,11/01/2023 05:43:00 AM,11/01/2023 07:28:13 AM,11/01/2023 08:15:10 AM
2023/09/12,DPH Only,0,0,0,0,0,0,0,0,247999,133820,125322,91514,78691,16912,36443,34601,11/01/2023 05:43:00 AM,11/01/2023 07:28:13 AM,11/01/2023 08:15:10 AM
2023/09/13,DPH Only,0,0,0,0,0,0,0,0,247999,133820,125322,91514,78691,16912,36443,34601,11/01/2023 05:43:00 AM,11/01/2023 07:28:13 AM,11/01/2023 08:15:10 AM
2023/09/14,DPH Only,0,0,0,0,0,0,0,0,247999,133820,125322,91514,78691,16912,36443,34601,11/01/2023 05:43:00 AM,11/01/2023 07:28:13 AM,11/01/2023 08:15:10 AM
2023/09/15,DPH Only,0,0,0,0,0,0,1,1,247999,133820,125322,91514,78691,16912,36444,34602,11/01/2023 05:43:00 AM,11/01/2023 07:28:13 AM,11/01/2023 08:15:10 AM
2023/09/16,DPH Only,0,0,0,0,0,0,0,0,247999,133820,125322,91514,78691,16912,36444,34602,11/01/2023 05:43:00 AM,11/01/2023 07:28:13 AM,11/01/2023 08:15:10 AM
2023/09/17,DPH Only,0,0,0,0,0,0,0,0,247999,133820,125322,91514,78691,16912,36444,34602,11/01/2023 05:43:00 AM,11/01/2023 07:28:13 AM,11/01/2023 08:15:10 AM
2023/09/18,DPH Only,0,0,0,0,0,0,0,0,247999,133820,125322,91514,78691,16912,36444,34602,11/01/2023 05:43:00 AM,11/01/2023 07:28:13 AM,11/01/2023 08:15:10 AM
2023/09/19,DPH Only,0,0,0,0,0,0,0,0,247999,133820,125322,91514,78691,16912,36444,34602,11/01/2023 05:43:00 AM,11/01/2023 07:28:13 AM,11/01/2023 08:15:10 AM
2023/09/20,DPH Only,0,0,0,0,0,0,0,0,247999,133820,125322,91514,78691,16912,36444,34602,11/01/2023 05:43:00 AM,11/01/2023 07:28:13 AM,11/01/2023 08:15:10 AM
2023/09/21,DPH Only,0,0,0,0,0,0,0,0,247999,133820,125322,91514,78691,16912,36444,34602,11/01/2023 05:43:00 AM,11/01/2023 07:28:13 AM,11/01/2023 08:15:10 AM
2023/09/22,DPH Only,0,0,0,0,0,0,0,0,247999,133820,125322,91514,78691,16912,36444,34602,11/01/2023 05:43:00 AM,11/01/2023 07:28:13 AM,11/01/2023 08:15:10 AM
2023/09/23,DPH Only,0,0,0,0,0,0,0,0,247999,133820,125322,91514,78691,16912,36444,34602,11/01/2023 05:43:00 AM,11/01/2023 07:28:13 AM,11/01/2023 08:15:10 AM
2023/09/24,DPH Only,0,0,0,0,0,0,0,0,247999,133820,125322,91514,78691,16912,36444,34602,11/01/2023 05:43:00 AM,11/01/2023 07:28:13 AM,11/01/2023 08:15:10 AM
2023/09/25,DPH Only,1,1,0,0,0,0,0,0,248000,133821,125322,91514,78691,16912,36444,34602,11/01/2023 05:43:00 AM,11/01/2023 07:28:13 AM,11/01/2023 08:15:10 AM
2023/09/26,DPH Only,0,0,0,0,0,0,0,0,248000,133821,125322,91514,78691,16912,36444,34602,11/01/2023 05:43:00 AM,11/01/2023 07:28:13 AM,11/01/2023 08:15:10 AM
2023/09/27,DPH Only,0,0,0,0,0,0,0,0,248000,133821,125322,91514,78691,16912,36444,34602,11/01/2023 05:43:00 AM,11/01/2023 07:28:13 AM,11/01/2023 08:15:10 AM
2023/09/28,DPH Only,0,0,0,0,0,0,0,0,248000,133821,125322,91514,78691,16912,36444,34602,11/01/2023 05:43:00 AM,11/01/2023 07:28:13 AM,11/01/2023 08:15:10 AM
2023/09/29,DPH Only,0,0,0,0,0,0,0,0,248000,133821,125322,91514,78691,16912,36444,34602,11/01/2023 05:43:00 AM,11/01/2023 07:28:13 AM,11/01/2023 08:15:10 AM
2023/09/30,DPH Only,0,0,0,0,0,0,0,0,248000,133821,125322,91514,78691,16912,36444,34602,11/01/2023 05:43:00 AM,11/01/2023 07:28:13 AM,11/01/2023 08:15:10 AM
2023/10/01,DPH Only,0,0,0,0,0,0,0,0,248000,133821,125322,91514,78691,16912,36444,34602,11/01/2023 05:43:00 AM,11/01/2023 07:28:13 AM,11/01/2023 08:15:10 AM
2023/10/02,DPH Only,0,0,0,0,0,0,0,0,248000,133821,125322,91514,78691,16912,36444,34602,11/01/2023 05:43:00 AM,11/01/2023 07:28:13 AM,11/01/2023 08:15:10 AM
2023/10/03,DPH Only,0,0,0,0,0,0,0,0,248000,133821,125322,91514,78691,16912,36444,34602,11/01/2023 05:43:00 AM,11/01/2023 07:28:13 AM,11/01/2023 08:15:10 AM
2023/10/04,DPH Only,0,0,0,0,0,0,0,0,248000,133821,125322,91514,78691,16912,36444,34602,11/01/2023 05:43:00 AM,11/01/2023 07:28:13 AM,11/01/2023 08:15:10 AM
2023/10/05,DPH Only,0,0,0,0,0,0,0,0,248000,133821,125322,91514,78691,16912,36444,34602,11/01/2023 05:43:00 AM,11/01/2023 07:28:13 AM,11/01/2023 08:15:10 AM
2023/10/06,DPH Only,0,0,0,0,0,0,0,0,248000,133821,125322,91514,78691,16912,36444,34602,11/01/2023 05:43:00 AM,11/01/2023 07:28:13 AM,11/01/2023 08:15:10 AM
2023/10/07,DPH Only,0,0,0,0,0,0,0,0,248000,133821,125322,91514,78691,16912,36444,34602,11/01/2023 05:43:00 AM,11/01/2023 07:28:13 AM,11/01/2023 08:15:10 AM
2023/10/08,DPH Only,0,0,0,0,0,0,0,0,248000,133821,125322,91514,78691,16912,36444,34602,11/01/2023 05:43:00 AM,11/01/2023 07:28:13 AM,11/01/2023 08:15:10 AM
2023/10/09,DPH Only,0,0,0,0,0,0,0,0,248000,133821,125322,91514,78691,16912,36444,34602,11/01/2023 05:43:00 AM,11/01/2023 07:28:13 AM,11/01/2023 08:15:10 AM
2023/10/10,DPH Only,1,1,1,0,0,0,0,0,248001,133822,125323,91514,78691,16912,36444,34602,11/01/2023 05:43:00 AM,11/01/2023 07:28:13 AM,11/01/2023 08:15:10 AM
2023/10/11,DPH Only,0,0,0,0,0,0,0,0,248001,133822,125323,91514,78691,16912,36444,34602,11/01/2023 05:43:00 AM,11/01/2023 07:28:13 AM,11/01/2023 08:15:10 AM
2023/10/12,DPH Only,0,0,0,0,0,0,0,0,248001,133822,125323,91514,78691,16912,36444,34602,11/01/2023 05:43:00 AM,11/01/2023 07:28:13 AM,11/01/2023 08:15:10 AM
2023/10/13,DPH Only,0,0,0,0,0,0,0,0,248001,133822,125323,91514,78691,16912,36444,34602,11/01/2023 05:43:00 AM,11/01/2023 07:28:13 AM,11/01/2023 08:15:10 AM
2023/10/14,DPH Only,1,1,0,0,0,0,0,0,248002,133823,125323,91514,78691,16912,36444,34602,11/01/2023 05:43:00 AM,11/01/2023 07:28:13 AM,11/01/2023 08:15:10 AM
2023/10/15,DPH Only,0,0,0,0,0,0,0,0,248002,133823,125323,91514,78691,16912,36444,34602,11/01/2023 05:43:00 AM,11/01/2023 07:28:13 AM,11/01/2023 08:15:10 AM
2023/10/16,DPH Only,0,0,0,0,0,0,0,0,248002,133823,125323,91514,78691,16912,36444,34602,11/01/2023 05:43:00 AM,11/01/2023 07:28:13 AM,11/01/2023 08:15:10 AM
2023/10/17,DPH Only,0,0,0,0,0,0,0,0,248002,133823,125323,91514,78691,16912,36444,34602,11/01/2023 05:43:00 AM,11/01/2023 07:28:13 AM,11/01/2023 08:15:10 AM
2023/10/18,DPH Only,0,0,0,0,0,0,0,0,248002,133823,125323,91514,78691,16912,36444,34602,11/01/2023 05:43:00 AM,11/01/2023 07:28:13 AM,11/01/2023 08:15:10 AM
2023/10/19,DPH Only,0,0,0,0,0,0,0,0,248002,133823,125323,91514,78691,16912,36444,34602,11/01/2023 05:43:00 AM,11/01/2023 07:28:13 AM,11/01/2023 08:15:10 AM
2023/10/20,DPH Only,0,0,0,1,0,0,0,0,248002,133823,125323,91515,78691,16912,36444,34602,11/01/2023 05:43:00 AM,11/01/2023 07:28:13 AM,11/01/2023 08:15:10 AM
2023/10/21,DPH Only,0,0,0,0,0,0,0,0,248002,133823,125323,91515,78691,16912,36444,34602,11/01/2023 05:43:00 AM,11/01/2023 07:28:13 AM,11/01/2023 08:15:10 AM
2023/10/22,DPH Only,0,0,0,0,0,0,0,0,248002,133823,125323,91515,78691,16912,36444,34602,11/01/2023 05:43:00 AM,11/01/2023 07:28:13 AM,11/01/2023 08:15:10 AM
2023/10/23,DPH Only,0,0,0,0,0,0,1,0,248002,133823,125323,91515,78691,16912,36445,34602,11/01/2023 05:43:00 AM,11/01/2023 07:28:13 AM,11/01/2023 08:15:10 AM
2023/10/24,DPH Only,0,0,0,0,0,0,0,0,248002,133823,125323,91515,78691,16912,36445,34602,11/01/2023 05:43:00 AM,11/01/2023 07:28:13 AM,11/01/2023 08:15:10 AM
2023/10/25,DPH Only,0,0,0,0,0,0,0,0,248002,133823,125323,91515,78691,16912,36445,34602,11/01/2023 05:43:00 AM,11/01/2023 07:28:13 AM,11/01/2023 08:15:10 AM
2023/10/26,DPH Only,0,0,0,0,0,0,0,0,248002,133823,125323,91515,78691,16912,36445,34602,11/01/2023 05:43:00 AM,11/01/2023 07:28:13 AM,11/01/2023 08:15:10 AM
2023/10/27,DPH Only,0,0,0,0,0,0,0,0,248002,133823,125323,91515,78691,16912,36445,34602,11/01/2023 05:43:00 AM,11/01/2023 07:28:13 AM,11/01/2023 08:15:10 AM
2023/10/28,DPH Only,0,0,0,0,0,0,0,0,248002,133823,125323,91515,78691,16912,36445,34602,11/01/2023 05:43:00 AM,11/01/2023 07:28:13 AM,11/01/2023 08:15:10 AM
2023/10/29,DPH Only,0,0,0,0,0,0,0,0,248002,133823,125323,91515,78691,16912,36445,34602,11/01/2023 05:43:00 AM,11/01/2023 07:28:13 AM,11/01/2023 08:15:10 AM
2023/10/30,DPH Only,0,0,0,0,0,0,0,0,248002,133823,125323,91515,78691,16912,36445,34602,11/01/2023 05:43:00 AM,11/01/2023 07:28:13 AM,11/01/2023 08:15:10 AM
2023/10/31,DPH Only,0,0,0,0,0,0,0,0,248002,133823,125323,91515,78691,16912,36445,34602,11/01/2023 05:43:00 AM,11/01/2023 07:28:13 AM,11/01/2023 08:15:10 AM
